Every_Heart_-민나노키모치-	artist	보아	o
GO_GO_서머!	artist	카라_(음악_그룹)	o
THE_맨파워!!!	artist	모닝구무스메	o
내_손을_잡아_(노래)	artist	아이유	o
눈동자의_멜로디	artist	보이프렌드_(음악_그룹)	o
다시_만난_세계	artist	소녀시대	o
디라이토_(대성의_음반)	artist	빅뱅_(음악_그룹)	x
라이징_스타	artist	타이미	o
바이바이_해피데이즈!	artist	카라_(음악_그룹)	o
베리_해피	artist	자니스WEST	o
부활LOVE	artist	아라시	o
빙글빙글_커튼	artist	노기자카46	o
아이오쿠라에	artist	슈퍼플라이	o
여성시대·영원한_사랑	artist	티아라_(음악_그룹)	o
웨이크_업!!	artist	유이카오리	o
키미와보쿠오스키니나루	artist	PASSPO☆	o
푸른_하늘_아래,_너의_옆	artist	아라시	o
8일째_매미	author	가쿠다_미쓰요	o
가족팔경	author	츠츠이_야스타카	o
두_사람이다	author	강경옥_(만화가)	x
오디세이_왜건,_인생을_달리다	author	시게마쓰_기요시	o
우리들에게_날개는_없다	author	시노즈카_가즈노리	x
잠들지_않는_나무	author	조소혜	o
캔디_캔디	author	이가라시_유미코	o
킥_애스_2	author	마크_밀러	o
퍼시픽_모비딕	author	허먼_멜빌	x
SG_워너비	bandMember	채동하	o
노브레인	bandMember	차승우	o
다이나믹_듀오	bandMember	프라이머리_(음악가)	x
들국화_(밴드)	bandMember	전인권	o
러브홀릭스	bandMember	강현민	o
롤링_스톤스	bandMember	제리_홀	x
메이필드_포	bandMember	마일즈_케네디	o
문차일드	bandMember	허정민	o
베란다_프로젝트	bandMember	이상순	o
베이비복스	bandMember	김형석_(음악가)	x
블락비	bandMember	유권	o
빅마마	bandMember	태빈	x
시나위_(밴드)	bandMember	박현준_(야구_선수)	x
언니네이발관	bandMember	이석원	o
원더걸스	bandMember	안소희	o
조나스_브라더스	bandMember	조_조너스	o
쥬얼리	bandMember	조민아	o
컬러스_(음악_그룹)	bandMember	강인원_(가수)	o
퀸스_오브_더_스톤_에이지	bandMember	존_폴_존스_(음악가)	x
견훤	battle	공산_동수_전투	o
대한민국_국방부	battle	베트남_전쟁	x
소련군	battle	흥남_철수_작전	x
안도_리키치	battle	제2차_세계_대전	o
알렉산드로스_3세_메가스	battle	가우가멜라_전투	o
야하라_히로미치	battle	오키나와_전투	o
에르네스트_르낭	battle	프로이센-프랑스_전쟁	x
영국군	battle	다이너모_작전	o
오다_노부나가	battle	세키가하라_전투	x
이순신	battle	사천_해전	o
제임스_롱스트리트	battle	서부_전선_(제1차_세계_대전)	o
조지_5세	battle	제1차_세계_대전	x
칼_12세	battle	나르바_전투_(1700년)	o
켄_로치	battle	스페인_내전	x
MBC_서울국제가요제	channel	문화방송	o
결혼_7년	channel	한국방송공사	o
능력자들	channel	문화방송	o
대한민국_행복발전소	channel	한국방송공사	o
더_엑스_팩터	channel	폭스_방송	o
명작_스캔들	channel	한국방송공사	o
모두_다_김치	channel	문화방송	o
불어라_미풍아	channel	문화방송	o
브라보_신세대	channel	한국방송공사	o
비교체험_여행기_그곳에서_살아보기	channel	문화방송	o
사랑이_사랑에게	channel	SBS_파워FM	x
섀도우파이터	channel	문화방송	o
스폰지밥_네모바지	channel	니켈로디언	o
알게될거야	channel	한국방송공사	o
의뢰인_K	channel	한국방송공사	o
정글피쉬	channel	한국방송공사	o
죠니_브라보	channel	폭스_방송	x
파워퍼프걸	channel	폭스_방송	x
호보_(드라마)	channel	문화방송	x
강희제	child	건륭제	x
교황_니콜라오_5세	child	루키우스_안나이우스_세네카	x
김창완	child	김창익	x
김형준_(1987년)	child	김세현_(야구_선수)	x
김희철_(가수)	child	김정모	x
나카오카_신타로	child	도쿠가와_요시노부	x
닌켄_천황	child	겐조_천황	x
대한제국_고종	child	조선_정조	x
루지에로_2세	child	하인리히_6세	x
루트비히_판_베토벤	child	프란츠_슈베르트	x
마티아스	child	루돌프_2세	x
마티아스	child	페르디난트_2세	x
마희성	child	마희범	x
메이지_천황	child	다이쇼_천황	o
사이고_다카모리	child	오쿠보_도시미치	x
사카모토_류이치	child	마츠다_류헤이	x
에드워드_3세	child	제1대_요크_공작_랭글리의_에드먼드	o
유거	child	전한_애제	x
유비	child	조조	x
잉마르_베리만	child	잉리드_툴린	x
전한_무제	child	전한_소제_(8대)	o
정철	child	송익필	x
제임스_먼로	child	윌리엄_헨리_해리슨	x
조_큐버트	child	애덤_큐버트	o
조선_예종	child	조선_성종	x
조선_정조	child	대한제국_순종	x
조선_태조	child	정도전	x
조선_태조	child	조선_선조	x
존_(잉글랜드)	child	필리프_2세_(프랑스)	x
켄_그리피_1세	child	켄_그리피_주니어	o
헌강왕	child	효공왕	o
황기영	child	황비홍	o
후트그투_칸_쿠살라	child	원_영종_(10대)	o
49제	director	이영우_(야구인)	x
YMCA_야구단	director	김현석_(축구인)	x
김의_전쟁	director	임상수	x
매트릭스_(영화)	director	더_워쇼스키스	o
미쓰_홍당무	director	이경미	o
박하사탕	director	봉준호	x
시라노;_연애조작단	director	김현석_(축구인)	x
군네라과	division	속씨식물	x
꼬리고사리과	division	양치류	o
나방	division	곤충	x
단문류	division	곤충	x
디메아투스속	division	피낭동물	o
딱따구리목	division	아프리카오색조류	x
딱정벌레목	division	곤충	x
마황문	division	겉씨식물	x
말즘	division	동물	x
말피기목	division	속씨식물	x
모니미아과	division	속씨식물	x
베르베리돕시스과	division	속씨식물	x
복숭아	division	가지_(식물)	x
부등편모조류	division	돌말류	x
비비아니아과	division	속씨식물	x
산석류과	division	속씨식물	x
유시아강	division	곤충	x
윤조강	division	선태식물	x
장미군	division	속씨식물	x
주발버섯류	division	균계	x
칼딜리네아과	division	세균	x
털곰팡이목	division	접합균류	x
하르펠라목	division	균계	x
협죽도과	division	속씨식물	x
훕바르디아속	division	속씨식물	x
고려_공민왕	dynasty	원나라	x
고려_공양왕	dynasty	조선	x
고려_원종	dynasty	고려	o
고려_원종	dynasty	원나라	x
고려_충정왕	dynasty	원나라	x
대한제국_고종	dynasty	조선	o
명성황후	dynasty	조선	o
북송_인종	dynasty	북송	o
아유르시리다르_빌레그트_칸	dynasty	원나라	o
원_성종	dynasty	명나라	x
조선_성종	dynasty	원나라	x
조선_세종	dynasty	대한민국	x
조선_숙종	dynasty	조선	o
조선_철종	dynasty	조선	o
조선_태종	dynasty	고려	x
조선_헌종	dynasty	조선	o
참회왕_에드워드	dynasty	프랑스군	x
천명제	dynasty	조선	x
쿠빌라이_칸	dynasty	시리아	x
토구스_테무르_우스칼_칸	dynasty	명나라	x
가야역_(한국철도공사)	era	가야	x
경주시	era	신라	o
경주역사유적지구	era	신라	o
공주시	era	백제	o
김유신	era	백제	x
나라_현	era	신라	x
대왕의_꿈	era	백제	x
백제역사유적지구	era	백제	o
범일역_(한국철도공사)	era	가야	x
부인사	era	신라	x
삼국지	era	고구려	x
삼도봉_(민주지산)	era	백제	x
서호	era	백제	x
수원_화성	era	조선	o
신라	era	고구려	x
연개소문	era	신라	x
연남생	era	신라	x
오카자키_성	era	에도_막부	x
임휴사	era	고려	x
태왕사신기	era	고구려	x
가리야목	family	카르디옵테리스과	x
감탕나무	family	필로노마과	x
개미	family	흰개미	x
검은담비	family	스컹크	x
게르프쥐여우원숭이	family	작은쥐여우원숭이	x
곤충	family	호랑나비상과	x
굴	family	흰개미	x
꼴뚜기과	family	살오징어아과	x
나도바랭이아과	family	단토니아아과	x
노랑발안테키누스	family	땃쥐류	x
노래미	family	쥐노래미	x
니그레스켄테스절	family	비발바리아아속	x
님바수달뒤쥐	family	애기수달뒤쥐속	x
다람쥐	family	우는토끼	x
달납줄개	family	납줄개속	x
독수리	family	매	x
드릴_(동물)	family	개코원숭이	x
딱따구리목	family	쥐새과	x
땃쥐목	family	아프리카두더지땃쥐류	x
로리스	family	유인원	x
말피기목	family	버드나무과	x
망토고함원숭이	family	고함원숭이	x
매실나무	family	살구나무	x
몽구스	family	쿠시만스속	x
무환자나무목	family	소태나무과	x
미루나무	family	버즘나무	x
바다가마우지	family	쇠가마우지	x
바위너구리	family	바위너구리과	o
버지니아주머니쥐	family	코요테	x
북극곰	family	큰곰	x
불독개미아과	family	공룡개미	x
붉은머리타마린	family	타마린	x
비버	family	날다람쥐족	x
비버	family	카피바라	x
사슴	family	양	x
사슴풍뎅이	family	사슴풍뎅이속	x
사헬란트로푸스	family	호모_하빌리스	x
살구나무	family	자두	x
상추	family	민들레	x
소나무속	family	잎갈나무속	x
스라소니속	family	카라칼속	x
쌍떡잎식물	family	아욱과	x
아프리카오릭스	family	긴칼뿔오릭스	x
아프리카코끼리	family	아프리카코끼리속	x
알락나방상과	family	굴벌레나방상과	x
앵두나무	family	모과나무	x
양추아노사우루스	family	메트리아칸토사우루스과	o
오갈피나무	family	팔손이	x
오스트레일리아청개구리속	family	왕청개구리	x
왜가리	family	매	x
유인원	family	개코원숭이	x
작은사슴	family	사슴	x
참복과	family	거북복과	x
참새목	family	아메리카솔새과	x
참수리	family	흰꼬리수리	x
청서번티기	family	청서번티기속	x
코아후일라케라톱스	family	카스모사우루스아과	o
큰뿔사슴	family	사슴	o
파랑새목	family	벌잡이새류	x
팔손이	family	두릅나무	x
팡가시우스	family	메콩메기과	o
하마	family	양	x
호모_에렉투스	family	호모_하빌리스	x
황금두더지	family	코끼리땃쥐	x
휘파람새과	family	솔새과	x
러브_스컬프쳐	genre	블루스	x
레이디_가가	genre	리듬_앤드_블루스	x
로니_제임스_디오	genre	블루스	x
보이존	genre	보이_밴드	o
본_이베어	genre	포크송	x
볼프강_아마데우스_모차르트	genre	인디_록	x
브라운_아이드_걸스	genre	리듬_앤드_블루스	o
블루_(음악_그룹)	genre	재즈	x
앤서니_키디스	genre	헤비_메탈	o
엘로	genre	네오_소울	x
이언_길런	genre	록_음악	o
이지_리스닝_(음반)	genre	블루스	x
조이_디비전	genre	신스팝	x
조현아	genre	재즈	x
치오도스	genre	하드코어_펑크	o
폴_데즈먼드	genre	재즈	o
가지예보	isPartOf	무르만스크_주	o
강서구_(서울특별시)	isPartOf	거제시	x
강서구_(서울특별시)	isPartOf	목동_(서울)	x
경기고등학교	isPartOf	하버드_대학교	x
경상남도	isPartOf	황해도	x
경신고등학교_(서울)	isPartOf	고려대학교	x
경주시	isPartOf	월성원자력발전소	x
경주시	isPartOf	충주시	x
경희대학교	isPartOf	한림대학교	x
공주시	isPartOf	익산시	x
광산구	isPartOf	북구_(포항시)	x
구로구	isPartOf	경인선	x
구르마_현	isPartOf	코몽자리_현	x
구이린_시	isPartOf	저우산_시	x
국립부여박물관	isPartOf	국립중앙박물관	x
군포시	isPartOf	북구_(포항시)	x
규슈	isPartOf	아마미_제도	x
그라나다	isPartOf	살라망카	x
그리니치빌리지	isPartOf	할렘	x
그리스	isPartOf	고대_아테네	x
그리스	isPartOf	키클라데스_제도	x
김제시	isPartOf	익산시	x
김천시	isPartOf	군위군	x
나망간	isPartOf	시르다리야_강	x
나카세케_구	isPartOf	마신디_구	x
나카세케_구	isPartOf	무코노_구	x
나카쓰_시	isPartOf	부젠_시	x
나콘랏차시마	isPartOf	사라부리	x
나파크_구	isPartOf	아무리아_구	x
남레이테_주	isPartOf	민다나오_섬	x
네브래스카_주	isPartOf	뉴멕시코_주	x
네비_구	isPartOf	키트굼_구	x
노르망디	isPartOf	아키텐	x
노스캐롤라이나_주	isPartOf	웨스트버지니아_주	x
누리스탄_주	isPartOf	쿠나르_주	x
누벨아키텐	isPartOf	오베르뉴론알프	x
뉴기니_섬	isPartOf	말레이_제도	x
뉴욕	isPartOf	노워크_(코네티컷_주)	x
뉴욕	isPartOf	롱아일랜드시티	x
뉴욕	isPartOf	상파울루	x
뉴욕	isPartOf	신시내티	x
뉴욕	isPartOf	이스트할렘	x
뉴욕	isPartOf	캔자스_주	x
뉴욕_주	isPartOf	뉴멕시코_주	x
뉴욕_주립_대학교	isPartOf	스토니브룩_대학교	x
뉴저지_주	isPartOf	버몬트_주	x
뉴질랜드	isPartOf	누벨칼레도니	x
뉴질랜드	isPartOf	오세아니아	o
다사읍	isPartOf	수성구	x
단둥_시	isPartOf	압록강	x
단원구	isPartOf	안산선	x
대구여자고등학교	isPartOf	이화여자대학교	x
대전광역시	isPartOf	평안도	x
대한민국	isPartOf	유럽_연합	x
덕양구	isPartOf	고려대학교	x
데니즐리_주	isPartOf	우샤크_주	x
데니즐리_주	isPartOf	이스파르타_주	x
데르나_주	isPartOf	알와하트_주	x
데바르_시	isPartOf	자야스_시	x
델라웨어_주	isPartOf	매사추세츠_주	x
델라웨어_주	isPartOf	펜실베이니아_주	x
도봉구	isPartOf	면목동	x
동대문구	isPartOf	한국농촌경제연구원	x
드로키아_구	isPartOf	돈두셰니_구	x
라도비시_시	isPartOf	바실레보_시	x
라스크루시스	isPartOf	와이오밍_주	x
런던	isPartOf	시티오브런던	x
런던	isPartOf	코펜하겐	x
런던	isPartOf	홀리루드_궁전	x
레이테_주	isPartOf	민다나오_섬	x
로마	isPartOf	북아메리카	x
로테르담	isPartOf	라인_강	x
롭부리_주	isPartOf	나콘나욕_주	x
롱아일랜드	isPartOf	코네티컷_주	x
루블린_주	isPartOf	우치_주	x
루이지애나_주	isPartOf	앨라배마_주	x
리베레츠_주	isPartOf	우스티_주	x
리베레츠_주	isPartOf	중앙보헤미아_주	x
리우데자네이루	isPartOf	대서양	x
리우데자네이루_주	isPartOf	미나스제라이스_주	x
리칠랜드_군_(사우스캐롤라이나_주)	isPartOf	사우스캐롤라이나_주	o
린셰핑	isPartOf	스톡홀름	x
마다바_주	isPartOf	요르단_강	x
마드리드	isPartOf	툴루즈	x
마라차_구	isPartOf	아주마니_구	x
마르딘_주	isPartOf	디야르바키르_주	x
마신디_구	isPartOf	불리사_구	x
마이애미	isPartOf	잭슨빌_(플로리다_주)	x
마투그로수_주	isPartOf	아마조나스_주	x
마투그로수_주	isPartOf	파라_주_(브라질)	x
마틴즈빌_(인디애나_주)	isPartOf	인디애나폴리스	x
마하사라캄	isPartOf	문_강	x
마하칼리_구	isPartOf	세티_구	x
만안구	isPartOf	삼영운수	x
말리	isPartOf	베냉	x
매사추세츠_공과대학교	isPartOf	조지아_공과대학교	x
메스케티	isPartOf	아할치헤	x
메인_주	isPartOf	뉴잉글랜드	o
메카	isPartOf	다마스쿠스	x
멕시코시티	isPartOf	미초아칸_주	x
멜라키_구	isPartOf	메나베_구	x
몐주_시	isPartOf	청두_시	x
모란봉구역	isPartOf	평양직할시	o
모리오카_시	isPartOf	센다이_시	x
목원대학교	isPartOf	감리교신학대학교	x
몬_주	isPartOf	양곤_관구	x
몬태나_주	isPartOf	와이오밍_주	x
몬트리올	isPartOf	밴쿠버	x
묵다한_주	isPartOf	마하사라캄_주	x
미국	isPartOf	멕시코_만	x
미국	isPartOf	워싱턴_주	x
미국	isPartOf	유럽	x
미국	isPartOf	텍사스_주	x
미네소타_주	isPartOf	캘리포니아_주	x
미시간_주립_대학교	isPartOf	코넬_대학교	x
미시시피_주	isPartOf	루이지애나_주	x
미시시피_주	isPartOf	인디애나_주	x
미주리_주	isPartOf	펜실베이니아_주	x
미티아나_구	isPartOf	부코만심비_구	x
밀워키	isPartOf	애틀랜타	x
바그다드	isPartOf	티그리스_강	x
바그마티_구	isPartOf	자낙푸르_구	x
바르샤바	isPartOf	비스와_강	x
바스노르망디	isPartOf	오트노르망디	x
바실란_주	isPartOf	칼리만탄우타라_주	x
바우카우_현	isPartOf	라우텡_현	x
발루치스탄	isPartOf	신드_주	x
발베르데_주	isPartOf	엘리아스피냐_주	x
배서스트_(뉴사우스웨일스_주)	isPartOf	뉴사우스웨일스_주	o
베누에_주	isPartOf	에도_주	x
베니_주	isPartOf	오루로_주	x
베르겐아우프뤼겐	isPartOf	뤼겐_섬	o
베스테르보텐_주	isPartOf	노르보텐_주	x
벨기에	isPartOf	노르트라인베스트팔렌_주	x
벨라루스	isPartOf	흑해	x
보이오티아_현	isPartOf	에비아_현	x
보퍼트_해	isPartOf	오호츠크_해	x
볼리비아	isPartOf	안데스_산맥	x
봉평면	isPartOf	용평면	x
봉화읍	isPartOf	영덕군	x
부산진구	isPartOf	중앙대로_(부산)	x
부셰니_구	isPartOf	루쿵기리_구	x
부코만심비_구	isPartOf	셈바불레_구	x
북수리가오_주	isPartOf	남수리가오_주	x
붕고마_현	isPartOf	서포코트_현	x
브네이브라크	isPartOf	텔아비브	x
브라질	isPartOf	동유럽	x
브라질	isPartOf	아프리카	x
브롱아하포_주	isPartOf	아샨티_주	x
브루클린	isPartOf	코네티컷_주	x
블레인_(미네소타_주)	isPartOf	왓컴_군	x
비아위스토크	isPartOf	프셰미실	x
비엘코폴스카_주	isPartOf	우치_주	x
비옴부_주	isPartOf	키나라_주	x
비잔티움_제국	isPartOf	로마_제국	x
비텐베르크	isPartOf	할레-비텐베르크_대학교	x
빌뉴스	isPartOf	다우가프필스	x
쁘라찐부리_주	isPartOf	나콘나욕_주	x
사마나_주	isPartOf	산토도밍고_주	x
사우스요크셔_주	isPartOf	랭커셔_주	x
사카테카스_주	isPartOf	텍사스_주	x
사할린_섬	isPartOf	코만도르스키예_제도	x
산타엘레나_주	isPartOf	엘오로_주	x
상록구	isPartOf	철원군_(남)	x
상파울루	isPartOf	서울특별시	x
상하이_시	isPartOf	베이징_대학	x
상하이_시	isPartOf	충칭_시	x
서구_(광주광역시)	isPartOf	영도구	x
서마케도니아_주	isPartOf	중앙그리스_주	x
서머싯_주	isPartOf	글로스터셔_주	x
서벵골_주	isPartOf	안드라프라데시_주	x
서벵골_주	isPartOf	차티스가르_주	x
서부_주_(우간다)	isPartOf	프와니_주	x
서울대학교	isPartOf	인하대학교	x
서울성경신학대학원대학교	isPartOf	합동신학대학원대학교	x
서포모제_주	isPartOf	실롱스크_주	x
선양_시	isPartOf	쓰촨_성	x
선츠_현	isPartOf	숴저우_시	x
성남시	isPartOf	안산시	x
성동구	isPartOf	서울숲	x
성북구	isPartOf	노원구	x
성산구	isPartOf	거제시	x
세인트루시아	isPartOf	서인도_연방	o
세인트루이스	isPartOf	뉴올리언스	x
셰르부르옥트빌	isPartOf	캉	x
소노라_주	isPartOf	뉴멕시코_주	x
소순다_열도	isPartOf	말레이_제도	o
솽류_구	isPartOf	바오딩_시	x
쇠데르만란드	isPartOf	외스테르예틀란드	x
수영구	isPartOf	연제구	x
수원시	isPartOf	평안남도	x
숙명여자대학교	isPartOf	대경대학교	x
스노_섬	isPartOf	사우스셰틀랜드_제도	o
스리랑카	isPartOf	솔로몬_제도	x
스투데니차니_시	isPartOf	일린덴_시	x
스페인	isPartOf	브리튼_제도	x
스페인	isPartOf	제노바_공화국	x
시기리_(기니)	isPartOf	나이저_강	x
시노프_주	isPartOf	카라뷔크_주	x
시애틀	isPartOf	유타_주	x
시애틀	isPartOf	포틀랜드_(오리건_주)	x
시카고	isPartOf	멜버른	x
시카고	isPartOf	아시아	x
실비치	isPartOf	롱비치_(캘리포니아_주)	x
싱부리_주	isPartOf	나콘빠톰_주	x
싱카왕	isPartOf	폰티아낙	x
아라우카_주	isPartOf	보야카_주	x
아메리칸_하키_리그	isPartOf	내셔널_하키_리그	o
아무리아_구	isPartOf	리라_구	x
아시아	isPartOf	버킷_리스트:_죽기_전에_꼭_하고_싶은_것들	x
아이다호_주	isPartOf	워싱턴_주	x
아주대학교	isPartOf	숭실대학교	x
아체_주	isPartOf	수마트라_섬	o
아카데미_각본상	isPartOf	아카데미_작품상	x
아칸소_주	isPartOf	켄터키_주	x
아타코라_주	isPartOf	알리보리_주	x
아파크_구	isPartOf	오얌_구	x
안바르_주	isPartOf	나자프_주	x
안산_(서울)	isPartOf	이화여자대학교	x
안티폴로	isPartOf	리살_주	o
암비테	isPartOf	마드리드	x
암스테르담	isPartOf	코펜하겐	x
앙카라_주	isPartOf	볼루_주	x
애너하임	isPartOf	로스앤젤레스	x
애리조나_주	isPartOf	미시간_주	x
애선스_(오하이오_주)	isPartOf	앨라배마_주	x
앨버커키	isPartOf	오하이오_주	x
앵커리지	isPartOf	와실라	x
양동시장역	isPartOf	광주_도시철도	o
양산시	isPartOf	밀양시	x
어퍼웨스트사이드	isPartOf	센트럴_파크	x
언더우드_국제대학	isPartOf	연세대학교	o
에든버러	isPartOf	런던	x
에든버러_페스티벌_프린지	isPartOf	에든버러_국제_페스티벌	x
에콰도르	isPartOf	이사벨라_섬	x
에히메_대학	isPartOf	니혼_대학	x
엘오로_주	isPartOf	아수아이_주	x
엘이에로_섬	isPartOf	카나리아_제도	o
엘패소	isPartOf	시우다드후아레스	x
연안군	isPartOf	황해도	x
영국	isPartOf	말라야_연방	x
영국	isPartOf	트리스탄다쿠냐_제도	x
영암군	isPartOf	화순군	x
예산군	isPartOf	천안시	x
오드프랑스	isPartOf	바스노르망디	x
오리건_주	isPartOf	미주리_주	x
오리건_주	isPartOf	산타페_가도	x
오버우어젤	isPartOf	프랑크푸르트암마인	x
오베르뉴	isPartOf	바스노르망디	x
오스트레일리아	isPartOf	토러스_해협_제도	x
오크니차_구	isPartOf	르슈카니_구	x
오클라호마_주	isPartOf	뉴멕시코_주	x
오트피레네_주	isPartOf	나바라_지방	x
오폴레_주	isPartOf	비엘코폴스카_주	x
오하이오_대학교	isPartOf	버지니아_대학교	x
오하이오_주	isPartOf	켄터키_주	x
옥스퍼드_대학교	isPartOf	맨체스터_대학교	x
옥탸브리스코이레볼류치_섬	isPartOf	세베르나야제믈랴_제도	o
옹진군_(인천광역시)	isPartOf	서산시	x
옹진군_(인천광역시)	isPartOf	해남군	x
와이오밍_주	isPartOf	노스플랫_강	x
완주군	isPartOf	논산시	x
요시다_정	isPartOf	사쿠라지마_섬	x
용산구	isPartOf	용산동_(서울)	x
우지체	isPartOf	로즈니차	x
우창_구	isPartOf	하얼빈_시	x
울주군	isPartOf	청도군	x
움살랄	isPartOf	알구와리야	x
워링턴	isPartOf	보르도	x
워싱턴_주	isPartOf	아이다호_주	x
유럽	isPartOf	로키_산맥	x
유럽_연합	isPartOf	유럽_의회	x
유성구	isPartOf	광주시_(경기도)	x
유타_대학교	isPartOf	브리검영_대학교	x
은코타코타	isPartOf	말라위_호	x
의왕시	isPartOf	군포시	x
의정부시	isPartOf	양주시	x
이르비드_주	isPartOf	발카_주	x
이반다_구	isPartOf	셰마_구	x
이부스키_시	isPartOf	마쿠라자키_시	x
이오_섬	isPartOf	사이판_섬	x
이타키_섬	isPartOf	이오니아_제도	o
이탈리아	isPartOf	북아메리카	x
익산시	isPartOf	하버드_대학교	x
일리노이_주	isPartOf	오클라호마_주	x
일본	isPartOf	아시아	o
잘츠부르크	isPartOf	바이에른_주	x
전주시	isPartOf	여주시	x
정읍시	isPartOf	단국대학교	x
제주시	isPartOf	제주시_탐라도서관	x
조지아_(국가)	isPartOf	흑해	x
중구_(서울특별시)	isPartOf	한강	x
중랑구	isPartOf	노원구	x
중러우_구	isPartOf	창저우_시_(허베이_성)	x
중앙아시아	isPartOf	동유럽	x
중화인민공화국	isPartOf	아랍_연합_공화국	x
지무나이_현	isPartOf	아러타이_시	x
징안_구	isPartOf	상하이_시	o
쯔중_현	isPartOf	루저우_시	x
차슈카_시	isPartOf	데미르카피야_시	x
차슈카_시	isPartOf	크루셰보_시	x
창사_시	isPartOf	쿤밍_시	x
창원시	isPartOf	김해시	x
초코_주	isPartOf	칼다스_주	x
충남대학교	isPartOf	동국대학교	x
치앙라이_주	isPartOf	치앙마이_주	x
칠레	isPartOf	엘키_현	x
카가얀_주	isPartOf	북일로코스_주	x
카게라_주	isPartOf	루콰_주	x
카롱가	isPartOf	말라위_호	x
카루지_주	isPartOf	키룬도_주	x
카르타고	isPartOf	알프스_산맥	x
카바다르치_시	isPartOf	데미르카피야_시	x
카보베르데	isPartOf	상비센트_섬	x
카세세_구	isPartOf	키발레_구	x
카셰우_주	isPartOf	오이우_주	x
카이세리_주	isPartOf	기레순_주	x
캄퐁참_주	isPartOf	스퉁트렝_주	x
캐나다	isPartOf	일본	x
캐나다	isPartOf	타이완	x
캐나다	isPartOf	포클랜드_제도	x
캐나다	isPartOf	폴란드	x
캔자스_대학교	isPartOf	엑서터_대학교	x
캔자스_주	isPartOf	하와이_주	x
커빙턴_(루이지애나_주)	isPartOf	킹_군_(워싱턴_주)	x
컬럼비아_(사우스캐롤라이나_주)	isPartOf	세인트루이스	x
컬럼비아_(사우스캐롤라이나_주)	isPartOf	컬럼비아_우주왕복선	x
컬럼비아_대학교	isPartOf	연세대학교	x
케임브리지_대학교	isPartOf	하버드_대학교	x
코네티컷_주	isPartOf	매사추세츠_주	x
코린티아_현	isPartOf	메시니아_현	x
코모도_섬	isPartOf	누사틍가라티무르_주	o
코아우일라_주	isPartOf	할리스코_주	x
쾰른	isPartOf	부에노스아이레스	x
쿤디나마르카_주	isPartOf	우일라_주_(콜롬비아)	x
퀸스	isPartOf	텍사스_대학교_오스틴	x
크레타	isPartOf	로도스_섬	x
클루지_주	isPartOf	아라드_주	x
클리블랜드	isPartOf	오하이오_주립_대학교	x
키르셰히르_주	isPartOf	네브셰히르_주	x
키시너우	isPartOf	커우셰니_구	x
키체보_시	isPartOf	자야스_시	x
킬리만자로_주	isPartOf	모로고로_주	x
타이완	isPartOf	소앤틸리스_제도	x
테살로니키	isPartOf	일리리아	x
톄링_시	isPartOf	랴오양_시	x
토아마시나_주	isPartOf	마하장가_주	x
토토니카판_주	isPartOf	수치테페케스_주	x
퉁하이_현	isPartOf	위시_시	o
튀니지	isPartOf	아틀라스_산맥	x
트렌친_주	isPartOf	반스카비스트리차_주	x
트빌리시	isPartOf	다게스탄_공화국	x
파리_(프랑스)	isPartOf	펜실베이니아_대학교	x
파푸아뉴기니	isPartOf	뉴브리튼_섬	x
팔레스타인	isPartOf	유럽	x
팡가시난_주	isPartOf	루손_섬	o
펑청_시_(단둥_시)	isPartOf	이춘_시_(헤이룽장_성)	x
페루	isPartOf	남아메리카	o
페트로베츠_시	isPartOf	스베티니콜레_시	x
페트로베츠_시	isPartOf	쿠마노보_시	x
펜서콜라	isPartOf	멕시코_만	x
평양직할시	isPartOf	요코하마_시	x
평양직할시	isPartOf	자강도	x
포토시_주	isPartOf	라파스_주_(볼리비아)	x
포트엘리자베스	isPartOf	이스트런던	x
프라하	isPartOf	모스크바	x
프랑스	isPartOf	마스카렌_제도	x
프랑스	isPartOf	브르타뉴	x
프래_주	isPartOf	나콘사완_주	x
프레더릭스버그_(버지니아_주)	isPartOf	리치먼드_(버지니아_주)	x
프리슬란트_주	isPartOf	니더작센_주	x
프릴레프	isPartOf	벨레스_(도시)	x
플로레슈티_구	isPartOf	르슈카니_구	x
플로리나_현	isPartOf	서마케도니아_주	o
플로리다_주	isPartOf	하와이_주	x
플로리다_준주	isPartOf	플로리다_주	x
피에몬테_주	isPartOf	토스카나_주	x
필리핀	isPartOf	말루쿠_제도	x
하바롭스크_지방	isPartOf	프리모르스키_지방	x
하버드_대학교	isPartOf	매사추세츠_공과대학교	x
하얼빈_시	isPartOf	항저우_시	x
하이데라바드_(인도)	isPartOf	신드_주	x
하이퐁	isPartOf	다낭	x
한국	isPartOf	충청남도	x
한반도	isPartOf	보령시	x
한반도	isPartOf	홋카이도	x
할리스코_주	isPartOf	미초아칸_주	x
함경남도	isPartOf	두만강	x
해머스미스	isPartOf	시티오브런던	x
해먼드_(인디애나_주)	isPartOf	시카고	x
향산군	isPartOf	자강도	x
혼슈	isPartOf	간토_지방	x
황해	isPartOf	연평도	x
구글	keyPerson	세르게이_브린	o
닌텐도	keyPerson	야마우치_히로시	o
드림웍스_애니메이션	keyPerson	톰_맥그래스	x
로켓_레코드_컴퍼니	keyPerson	엘튼_존	o
미스_유니버스	keyPerson	도널드_트럼프	o
브리지스톤	keyPerson	이시바시_쇼지로	o
워너_브라더스	keyPerson	캐서린_헵번	x
저스트뮤직	keyPerson	천재노창	o
제너럴_모터스	keyPerson	프랭클린_D._루스벨트	x
카툰_네트워크_스튜디오	keyPerson	리베카_슈거	x
파라마운트_픽쳐스	keyPerson	앤서니_에드워즈	x
포드_모터_컴퍼니	keyPerson	재키_윌슨	x
픽사	keyPerson	피트_닥터	o
한국방송공사	keyPerson	서혜정	x
가와바타_야스나리	knownFor	설국	o
공형진	knownFor	KBS_뉴스_9	x
구로사와_아키라	knownFor	붉은_수염	o
권상우	knownFor	기담	x
김승우	knownFor	신_귀공자	o
다이앤_레인	knownFor	리틀_로망스	o
다카하타_이사오	knownFor	귀를_기울이면	x
레오나르도_다_빈치	knownFor	모나리자	o
리누스_토르발스	knownFor	리눅스	o
미셸_모너핸	knownFor	미션_임파서블_3	o
박성우_(만화가)	knownFor	영_간간	x
발터_그로피우스	knownFor	데사우	x
빈센트_반_고흐	knownFor	밤의_카페_테라스	o
송기윤	knownFor	바람은_불어도	o
스다_마사키	knownFor	테니스의_왕자	x
스티브_피크	knownFor	리그_오브_레전드	o
시어도어_루스벨트	knownFor	브로드웨이	x
심혜진	knownFor	당신_옆이_좋아	x
아돌프_히틀러	knownFor	나의_투쟁	o
엄지원	knownFor	매직_(드라마)	o
에도가와_코난	knownFor	마녀_배달부_키키	x
이언_플레밍	knownFor	치티치티뱅뱅_(영화)	x
이창동	knownFor	박하사탕	o
제임스_마시	knownFor	맨_온_와이어	o
클로드_프롤로	knownFor	파리의_노트르담	x
톰_행크스	knownFor	아폴로_13	o
헨리크_입센	knownFor	페르_귄트	o
눈의_꽃	language	한국어	x
도라도라_영어나라	language	스페인어	o
라일로	language	영어	x
바이두백과	language	중국어	o
술의_나라	language	노르웨이어	x
오토캐드	language	한국어	x
위키백과	language	영어	o
위키백과	language	폴란드어	o
위키백과	language	한문	x
위키트래블	language	영어	o
윈도우_NT_3.5	language	한국어	x
인터내셔널_뉴욕_타임스	language	영어	o
집결호	language	영어	x
춘추좌씨전	language	광둥어	x
광둥어	languageFamily	민난어	x
라트비아어	languageFamily	우크라이나어	x
리키아어	languageFamily	시데어	x
리키아어	languageFamily	카리아어	x
말라가시어	languageFamily	테툼어	x
벨라루스어	languageFamily	헝가리어	x
셀쿠프어	languageFamily	러시아어	x
소그드어	languageFamily	웨일스어	x
스페인어	languageFamily	독일어	x
일본어	languageFamily	네덜란드어	x
일본어	languageFamily	핀란드어	x
중국어	languageFamily	베트남어	x
중국어	languageFamily	불가리아어	x
중국어	languageFamily	스페인어	x
카렐리야어	languageFamily	네네츠어	x
프랑스어	languageFamily	이디시어	x
프랑스어	languageFamily	일본어	x
프랑스어	languageFamily	체코어	x
프랑스어	languageFamily	히브리어	x
핀란드어	languageFamily	베트남어	x
한국어	languageFamily	몽골어	x
헝가리어	languageFamily	롬어	x
히브리어	languageFamily	코이네_그리스어	x
노동당_(영국)	leader	데이비드_캐머런	x
대한민국_국회	leader	장면	x
민주사회를_위한_변호사_모임	leader	박원순	x
민주진보당	leader	마잉주	x
오스트리아_연방육군	leader	프란츠_콘라트_폰_회첸도르프_백작	x
이스라엘_방위군	leader	레비_에슈콜	x
자유민주당_(일본)	leader	구리바야시_다다미치	x
자유민주당_(일본)	leader	후쿠다_야스오	x
중화인민공화국_국무원	leader	황쥐	x
한국	leader	변희봉	x
한국	leader	최영의	x
한국	leader	홍범도	x
FC_루빈_카잔	league	프리미어리그	x
FC_바이에른_뮌헨	league	세리에_A	x
다윈_바니	league	메이저_리그_베이스볼	o
디트로이트_타이거스	league	마이너_리그_베이스볼	x
마레크_얀쿨로프스키	league	세리에_A	x
마스부치_다쓰요시	league	센트럴_리그	o
마이애미_히트	league	사우스이스트_디비전_(NBA)	o
볼티모어_오리올스	league	마이너_리그_베이스볼	x
브와제이_아우구스틴	league	엑스트라클라사	o
사이토_유키_(1988년)	league	퍼시픽_리그	o
샌프란시스코_데몬스	league	서부_콘퍼런스_(NBA)	x
세인트루이스_카디널스	league	메이저_리그_베이스볼	o
세인트루이스_카디널스	league	텍사스_리그	o
송진형	league	K리그	o
알아흘리_(두바이)	league	프리미어리그	x
오스틴_로민	league	메이저_리그_베이스볼	o
조_콜	league	북미_축구_리그	o
조바_체임벌린	league	메이저_리그_베이스볼	o
짐_아이젠라이크	league	메이저_리그_베이스볼	o
채드_크루터	league	메이저_리그_베이스볼	o
칼초_파도바	league	세리에_A	x
포틀랜드_팀버스	league	북미_축구_리그	x
폴_개스코인	league	세리에_A	x
스티브_브루스	managerClub	카디프_시티_FC	x
알렉스_퍼거슨	managerClub	ACF_피오렌티나	x
알렉스_퍼거슨	managerClub	리즈_유나이티드_AFC	x
알렉스_퍼거슨	managerClub	맨체스터_시티_FC	x
알렉스_퍼거슨	managerClub	에버턴_FC	x
알렉스_퍼거슨	managerClub	울버햄프턴_원더러스_FC	x
기아_타우너	manufacturer	기아자동차	o
닛산_마치	manufacturer	닛산_자동차	o
닛산_스카이라인	manufacturer	메르세데스-벤츠	x
닷지_다코타	manufacturer	닷지	o
메르세데스-벤츠_C_클래스	manufacturer	메르세데스-벤츠	o
메르세데스-벤츠_SLR_맥라렌	manufacturer	다임러_AG	o
쉐보레_올란도	manufacturer	한국GM	o
스마트_포투	manufacturer	스마트_(자동차)	o
아우디_RS7	manufacturer	아우디	o
암트랙_뷰라이너	manufacturer	암트랙	x
토요타_2000GT	manufacturer	토요타_자동차	o
포드_20M	manufacturer	현대자동차	o
포르쉐_파나메라	manufacturer	폭스바겐	x
폭스바겐_비틀	manufacturer	포르쉐	x
현대_슈퍼트럭	manufacturer	대우중공업	x
현대_슈퍼트럭	manufacturer	미쓰비시후소트럭_버스	x
동탁	opponent	장제_(후한)	o
동탁	opponent	후한_헌제	x
문재인	opponent	박근혜	o
백선엽	opponent	유재흥	x
악진	opponent	조조	x
우금	opponent	장수_(후한)	o
우금	opponent	조조	x
위연	opponent	마속	x
임호균	opponent	김정수_(1962년)	x
장수_(후한)	opponent	관우	x
장수_(후한)	opponent	마속	x
장수_(후한)	opponent	북송_태조	x
장수_(후한)	opponent	손견	x
조운_(촉한)	opponent	유비	x
갈색발왕개미	order	벌목_(곤충)	o
개복치	order	오징어	x
거미	order	도마뱀	x
거미강	order	기생진드기상목	x
검룡류	order	후양고사우루스	x
검은반점쿠스쿠스	order	유대류	x
고래상어	order	수염고래아목	x
곤충	order	갑각류	x
곤충	order	강도래	x
곰치과	order	조기어류	x
공룡	order	조반목	x
광비원류	order	포유류	x
까불이족제비여우원숭이	order	여우원숭이	x
까치딱새류	order	새	x
꼬마주머니쥐속	order	유대류	x
나르키네과	order	연골어류	x
나무늘보	order	포유류	x
나무발발이상과	order	새	x
납작머리땃쥐	order	포유류	x
네모데르마_팅기타눔	order	갈조류	x
능구렁이	order	설치류	x
대구목	order	조기어류	x
데스마토수쿠스	order	지배파충류	x
도마뱀	order	뱀	x
도요목	order	꼬마물떼새	x
돌조개목	order	홍합	x
동갈돔과	order	조기어류	x
되새과	order	참새	x
딱정벌레목	order	물땡땡이과	x
딱정벌레목	order	지렁이	x
라이톤린상	order	포유류	x
레비아시나과	order	조기어류	x
로라이마쥐	order	비단털쥐	x
마취목	order	쌍떡잎식물	x
말벌상과	order	곤충	x
매퉁이과	order	조기어류	x
맵시벌과	order	곤충	x
메갈로사우루스	order	공룡	x
메소스티그마	order	별해캄목	x
명금류	order	참새하목	x
명주달팽이	order	복족류	x
무환자나무목	order	장미목	x
문절망둑	order	물고기	x
물고기	order	도마뱀	x
민다나오땃쥐	order	포유류	x
밤게과	order	연갑강	x
배각류	order	다지류	x
배각류	order	소각류	x
뱅가이쿠스쿠스	order	유대류	x
버마족제비오소리	order	포유류	x
범고래	order	갈매기	x
베도라치아목	order	조기어류	x
벨루사우루스	order	공룡	x
부채머리수리	order	뱀	x
사람아과	order	침팬지	x
사향고양이하목	order	하이에나	x
샛비늘치목	order	조기어류	x
설치류	order	멧밭쥐	x
섬초롱꽃	order	초롱꽃목	x
세룡	order	양서류	x
술라웨시난쟁이쿠스쿠스	order	유대류	x
쉴리터두더지땃쥐	order	포유류	x
시노케라톱스	order	각룡류	o
신월가자미과	order	조기어류	x
십각목	order	수상새아목	x
십완상목	order	초형아강	x
쌍살벌	order	나비	x
아이젠트라우트쥐땃쥐	order	포유류	x
아켈로우사우루스	order	케라톱스	x
양볼락아목	order	조기어류	x
에티오피아멧토끼	order	포유류	x
영장류	order	곤충	x
오징어	order	상어	x
올링기토	order	포유류	x
윈난멧토끼	order	포유류	x
임마과	order	나방	x
전갱이목	order	조기어류	x
전복	order	성게류	x
조록나무과	order	프로테아목	x
주걱벌레붙이목	order	연갑강	x
주걱치목	order	농어아목	x
주청케라톱스	order	렙토케라톱스	x
준치	order	멸치	x
짧은귀주머니쥐	order	유대류	x
차오양사우루스과	order	각룡류	x
캥거루아목	order	유대류	x
코일루루스	order	공룡	x
콘도르과	order	맹금류	x
콘드리엘라_푸실라	order	진정홍조강	x
크네모필루스과	order	새	x
큰박쥐류	order	관박쥐	x
킬로돈과	order	조기어류	x
킬리만자로땃쥐	order	포유류	x
테르모프로테우스목	order	테르모프로테우스강	x
토로사우루스	order	도마뱀	x
퉁가리과	order	물고기	x
티라노사우루스과	order	공룡	x
파이오필라속	order	갈파래강	x
햄스터	order	거북	x
홍조식물	order	네마스토마목	x
JYP_엔터테인먼트	owner	브랜뉴뮤직	x
게이큐_본선	owner	동일본여객철도	x
게이큐_본선	owner	서일본여객철도	x
고짓코쿠_역	owner	홋카이도_여객철도	o
구글	owner	엔비디아	x
금호타이어	owner	아시아나항공	x
런던_개트윅_공항	owner	영국항공	x
록스타_리즈	owner	록스타_게임스	o
미스_월드	owner	미스_인터내셔널	x
밀라노_말펜사_공항	owner	알리탈리아_항공	x
생텍쥐페리_국제공항	owner	에어프랑스	x
성남시	owner	대한송유관공사	x
성남시	owner	한국토지주택공사	x
세이브존	owner	금호아시아나그룹	x
소스포지	owner	구글	x
시로이시_시	owner	홋카이도_여객철도	x
아오바_역	owner	홋카이도_여객철도	o
알리안츠_아레나	owner	TSV_1860_뮌헨	x
오스트레일리아_항공	owner	콴타스_항공	x
온네나이_역	owner	홋카이도_여객철도	o
인천_도시철도	owner	가천대학교	x
코니카_미놀타	owner	소니	x
퀄컴	owner	엔비디아	x
파리_오를리_공항	owner	브릿_에어	x
홋카이도	owner	동일본_고속도로	x
루이_19세	parent	오스트리아의_마리_테레즈	x
에드먼드_1세	parent	헨리_3세	x
예수	parent	사도_요한	x
유리_조르카에프	parent	장_조르카에프	o
윤증현	parent	이건희	x
이순신	parent	조선_선조	x
조선_단종	parent	조선_세조	x
조선_태종	parent	고려_태조	x
카를_5세	parent	프랑수아_1세_(프랑스)	x
카미스_카다피	parent	무아마르_알_카다피	o
코제트	parent	팡틴	o
효철의황후	parent	서태후	x
구글	product	웹킷	x
넥슨	product	한게임	x
넷플릭스	product	제시카_존스_(드라마)	x
루프트한자	product	루프트한자_시티라인	x
마이크로소프트	product	마이크로소프트_워드	o
마이크로소프트	product	비주얼_C++	o
마이크로소프트	product	안드로이드_(운영_체제)	x
마이크로소프트	product	액티브X	o
모질라_재단	product	시몽키	x
모토로라_인코퍼레이티드	product	모토블러	x
소니_인터랙티브_엔터테인먼트	product	안드로이드_(운영_체제)	x
슈에이샤	product	바쿠만	x
어도비_시스템즈	product	아파치_플렉스	o
DJMAX_RAY	publisher	네오위즈홀딩스	x
나이트_온라인	publisher	엠게임	o
네버윈터_나이츠	publisher	바이오웨어	o
댄스_댄스_레볼루션_with_마리오	publisher	코나미	o
드래곤_컬렉션	publisher	코나미	o
리코쳇	publisher	밸브_코퍼레이션	o
마리오브라더스	publisher	닌텐도	o
메이플스토리	publisher	위젯_스튜디오	o
메이플스토리_2	publisher	넥슨	o
메탈레이지	publisher	넥슨지티	o
바이오쇼크_인피니트	publisher	마이크로소프트	x
뱀파이어_나이트	publisher	반다이_남코_엔터테인먼트	o
블레이드_앤_소울	publisher	엔씨소프트	o
스와트_4	publisher	비방디	x
심타워	publisher	마이크로소프트	x
완다와_거상	publisher	소니_인터랙티브_엔터테인먼트	o
워록	publisher	드림익스큐션	o
유비트_코피어스	publisher	코나미	o
포켓몬스터_오메가루비·알파사파이어	publisher	닌텐도	o
50센트	recordLabel	애프터매스_엔터테인먼트	o
닥터_드레	recordLabel	애프터매스_엔터테인먼트	o
데이먼_대시	recordLabel	데프_잼_레코딩스	x
데이먼_대시	recordLabel	로커펠라_레코드	x
루다크리스	recordLabel	데프_잼_레코딩스	o
샤니아_트웨인	recordLabel	아리스타_레코드	x
숀_콤스	recordLabel	애프터매스_엔터테인먼트	x
애프터매스_엔터테인먼트	recordLabel	셰이디_레코드	x
어셔	recordLabel	아일랜드_레코드	x
에미넴	recordLabel	셰이디_레코드	o
자_룰	recordLabel	데프_잼_레코딩스	o
재팬_(밴드)	recordLabel	큔_뮤직	x
제이지	recordLabel	데프_잼_레코딩스	o
캄론	recordLabel	로커펠라_레코드	o
캠프_락	recordLabel	할리우드_레코드	x
탑_독_엔터테인먼트	recordLabel	인터스코프_레코드	x
김규식	relative	안재홍	x
김동석_(1966년)	relative	장동건	x
노엘_갤러거	relative	리엄_갤러거	o
루이즈_마운트배튼	relative	제1대_버마의_마운트배튼_백작_루이스_마운트배튼	o
박은식	relative	조동호	x
서재필	relative	박영효	x
셰인_맥마흔	relative	스테퍼니_맥마흔	o
안중근	relative	윤봉길	x
윤치영	relative	윤치호	o
이기붕	relative	김규식	x
이상재	relative	허헌	x
이순신	relative	윤휴	o
장면	relative	장택상	x
정명훈	relative	정경화	o
주희	relative	주돈이	x
체사레_보르자	relative	호프레_보르자	o
테오_반_고흐_(미술상)	relative	빈센트_반_고흐	o
토마스_맥켈리	relative	프랜시스_휴스	o
한명회	relative	김질_(1422년)	x
홍명희	relative	허헌	x
교황_텔레스포로	religion	가르멜회	x
도미니코	religion	도미니코_수도회	x
브리검영_대학교	religion	예수_그리스도_후기성도_교회	o
기시_노부스케	spouse	아베_신조	x
김영춘_(1962년)	spouse	신기남	x
김진아_(배우)	spouse	양자경	x
김현중	spouse	구혜선	x
나르세스	spouse	토틸라	x
나카무라_토오루	spouse	에모토_아키라	x
나카소네_야스히로	spouse	하시모토_류타로	x
니콜_키드먼	spouse	존_캐머런_미첼	x
데이비드_핀처	spouse	라세_할스트룀	x
라이언_고즐링	spouse	캐리_멀리건	x
레이철_매캐덤스	spouse	베네딕트_웡	x
로멀러_개리	spouse	크리스토퍼_리	x
로베르트_슈벤트케	spouse	레이철_매캐덤스	x
리나_(펜싱_선수)	spouse	쉬안치	x
리베카_슈거	spouse	펜들턴_워드	x
마이클_섀넌	spouse	코디_스밋맥피	x
막시_헤르버	spouse	에른스트_바이어	o
미셸_모너핸	spouse	모건_프리먼	x
박미선	spouse	김성은_(군인)	x
박상아	spouse	조민기	x
박수홍	spouse	윤기원_(배우)	x
박지아	spouse	하정우	x
백지영	spouse	박장근	x
버락_오바마	spouse	엘레나_케이건	x
부르빌	spouse	루이_드_퓌네스	x
브래드_피트	spouse	줄리아_로버츠	x
샤를리즈_테론	spouse	크리스티나_헨드릭스	x
서영교	spouse	김다니	x
선우용여	spouse	장정희	x
세라_페일린	spouse	존_매케인	x
송강호	spouse	존_허트	x
쉬안치	spouse	뤄샤오쥐안	x
스코티_톰프슨	spouse	브리트니_대니얼	x
스파이더맨	spouse	메리_제인_왓슨	o
시드니_폴락	spouse	바브라_스트라이샌드	x
신창원	spouse	유영철	x
신현준_(군인)	spouse	정재영	x
아르투르_아빌라	spouse	만줄_바르가바	x
아리크부카	spouse	차가타이_칸	x
안석주	spouse	윤봉춘	x
알바로_오브레곤	spouse	에밀리아노_사파타	x
알베르토_후지모리	spouse	게이코_후지모리	x
애니_점프_캐넌	spouse	헨리에타_스완_리비트	x
애덤_무토	spouse	리베카_슈거	x
앤_해서웨이	spouse	로즈메리_디윗	x
앨프리드_히치콕	spouse	조지_큐커	x
엘리자베타_알렉세예브나	spouse	세르게이_키로프	x
오스트리아의_마리아_아말리아_(1701년)	spouse	페르디난도_1세_(양시칠리아)	x
우위썬	spouse	에런_엑하트	x
윌리엄_셰익스피어	spouse	엘런_테리	x
유재석	spouse	김준호_(희극인)	x
유진위	spouse	장만옥	x
이대진	spouse	신동수_(야구인)	x
이루마	spouse	조지_윈스턴	x
이선주	spouse	한인숙	x
이용규	spouse	홍현우	x
이효정_(배우)	spouse	선우재덕	x
임예진	spouse	남성진	x
임청하	spouse	관즈린	x
장성민	spouse	박중훈	x
장필순	spouse	박정운	x
잭_스나이더	spouse	매슈_구드	x
정우성	spouse	손예진	x
제시카_비엘	spouse	브래들리_쿠퍼	x
제시카_채스테인	spouse	톰_히들스턴	x
제이미_벨	spouse	틸다_스윈턴	x
조선_태종	spouse	측천무후	x
조지_클루니	spouse	브래드_피트	x
지미_카터	spouse	로널드_레이건	x
차지철	spouse	김계원	x
찰스_위드모어	spouse	케이트_오스틴	x
카야_스코델라리오	spouse	프랜시스_오코너	x
코엔_형제	spouse	하비에르_바르뎀	x
클린트_이스트우드	spouse	리_밴클리프	x
킬리언_머피	spouse	켈리_맥도널드	x
토머스_제퍼슨	spouse	에런_버	x
톰_행크스	spouse	아키바_골즈먼	x
펠리페_5세	spouse	파르마의_마리아_루이사_(1751년)	x
프랭클린_D._루스벨트	spouse	존_낸스_가너	x
프리드리히_하이에크	spouse	밀턴_프리드먼	x
헬무트_쇤	spouse	헤네스_바이스바일러	x
황신혜	spouse	김승수_(배우)	x
경마장_가는_길	subsequentWork	결혼_이야기	x
그들도_우리처럼	subsequentWork	결혼_이야기	x
나이트메어_(2010년_영화)	subsequentWork	파이널_데스티네이션_5	x
내_사랑_팥쥐	subsequentWork	위풍당당_그녀	x
다빈치_코드	subsequentWork	천사와_악마	x
데쓰_프루프	subsequentWork	플래닛_테러	x
두사부일체	subsequentWork	색즉시공	o
미션_임파서블	subsequentWork	수퍼맨_리턴즈	x
바람_피기_좋은_날	subsequentWork	냄새를_보는_소녀_(드라마)	x
바이센테니얼맨	subsequentWork	판타스틱_4_(2005년_영화)	x
세상의_중심에서_사랑을_외치다	subsequentWork	태양의_노래	x
슈퍼스타_감사용	subsequentWork	돌아온_일지매	x
슈퍼스타_감사용	subsequentWork	비밀애	x
스타십_트루퍼스	subsequentWork	토탈_리콜	x
스트리트_킹	subsequentWork	퓨리_(2014년_영화)	o
에반_올마이티	subsequentWork	겟_스마트_(영화)	x
요술공주_샐리	subsequentWork	바벨_2세	x
잉글리쉬_페이션트	subsequentWork	콜드_마운틴	o
작안의_샤나	subsequentWork	토라도라!	x
쥬만지	subsequentWork	다이하드_3	x
캔디맨_(영화)	subsequentWork	불멸의_연인	o
콜롬비아나	subsequentWork	테이큰_3	o
판타스틱_4_(2015년_영화)	subsequentWork	엑스맨_(영화_시리즈)	x
FIFA_클럽_월드컵	team	AC_밀란	o
K3리그	team	경주_시민축구단	o
K3리그	team	고려대학교_축구부	x
K리그	team	노스이스트_유나이티드_FC	x
K리그	team	전북_현대_모터스	x
그레미우	team	아틀레치쿠_파라나엔시	x
김민수_(격투기_선수)	team	서울_SK_나이츠	x
내셔널_하키_리그	team	토론토_메이플리프스	o
니코_(가수)	team	레알_마드리드_카스티야	x
대한민국_축구_국가대표팀	team	발렌시아_CF	x
데포르티보_라코루냐	team	리버풀_FC	x
도널드_덕	team	뉴욕_양키스	x
라리가	team	SC_바스티아	x
라리가	team	레알_베티스	o
래리_존슨_(농구_선수)	team	뉴올리언스_펠리컨스	x
리그_1	team	FC_낭트	o
리그_1	team	FC_서울	x
맷_홀리데이	team	뉴욕_양키스	o
비에이리냐	team	포르투갈_축구_국가대표팀	o
사우디아라비아_축구_국가대표팀	team	FC_서울	x
세리에_A	team	포자_칼초	o
에레디비시	team	브뢴뷔_IF	x
커트_실링	team	뉴욕_양키스	x
콘티넨탈_하키_리그	team	FC_디나모_모스크바	x
텍사스_레인저스	team	미네소타_트윈스	x
페르난도_에르난데스	team	디트로이트_타이거스	o
페예노르트	team	AC_밀란	x
포르투갈_축구_국가대표팀	team	SL_벤피카	x
프리미어리그	team	AFC_본머스	o
피츠버그_파이리츠	team	애틀랜타_브레이브스	x
한국프로농구	team	보스턴_셀틱스	x
뉴욕_대학교	type	티시_예술대학	x
도쿄_대학	type	와세다_대학	x
브라운_대학교	type	예일_대학교	x
스탠퍼드_대학교	type	와세다_대학	x
한국폴리텍6대학	type	한국폴리텍대학	o
한국폴리텍7대학	type	한국폴리텍대학	o
