Every_Heart_-민나노키모치-	artist	보아	o
GO_GO_서머!	artist	카라_(음악_그룹)	o
Over_the_Rainbow	artist	장진영	x
THE_맨파워!!!	artist	모닝구무스메	o
내_손을_잡아_(노래)	artist	아이유	o
눈동자의_멜로디	artist	보이프렌드_(음악_그룹)	o
다시_만난_세계	artist	소녀시대	o
디라이토_(대성의_음반)	artist	빅뱅_(음악_그룹)	o
라이징_스타	artist	타이미	o
러브_네버_다이즈	artist	팬텀_(음악_그룹)	x
마이_페어_레이디	artist	마리아_(예수의_어머니)	x
바이바이_해피데이즈!	artist	카라_(음악_그룹)	o
베리_해피	artist	자니스WEST	o
부활LOVE	artist	아라시	o
빙글빙글_커튼	artist	노기자카46	o
아이오쿠라에	artist	슈퍼플라이	o
여성시대·영원한_사랑	artist	티아라_(음악_그룹)	o
웨이크_업!!	artist	유이카오리	o
키미와보쿠오스키니나루	artist	PASSPO☆	o
푸른_하늘_아래,_너의_옆	artist	아라시	o
8일째_매미	author	가쿠다_미쓰요	o
가족팔경	author	츠츠이_야스타카	o
걸리버_여행기	author	로렌스_스턴	x
구오대사	author	조선_태종	x
기네스_세계_기록	author	잔_칼망	x
달의_요정_세일러문_(만화)	author	츠키노_우사기	x
독한_것들의_진짜_운동법	author	박용우	x
두_사람이다	author	강경옥_(만화가)	o
북두의_권	author	유비	x
삼국사기	author	해모수왕	x
삼국지연의	author	주유	x
수사반장	author	애거사_크리스티	x
오디세이_왜건,_인생을_달리다	author	시게마쓰_기요시	o
우리들에게_날개는_없다	author	시노즈카_가즈노리	o
자치통감	author	연개소문	x
잠들지_않는_나무	author	조소혜	o
캔디_캔디	author	이가라시_유미코	o
쾌걸_조로리	author	하라_다쓰노리	x
킥_애스_2	author	마크_밀러	o
퍼시픽_모비딕	author	허먼_멜빌	o
SG_워너비	bandMember	채동하	o
노브레인	bandMember	차승우	o
다이나믹_듀오	bandMember	프라이머리_(음악가)	o
들국화_(밴드)	bandMember	전인권	o
러브홀릭스	bandMember	강현민	o
롤링_스톤스	bandMember	제리_홀	o
메이트_(음악_그룹)	bandMember	임헌일	x
메이필드_포	bandMember	마일즈_케네디	o
문차일드	bandMember	허정민	o
베란다_프로젝트	bandMember	이상순	o
베이비복스	bandMember	김형석_(음악가)	o
블락비	bandMember	유권	o
빅마마	bandMember	태빈	o
시나위_(밴드)	bandMember	박현준_(야구_선수)	o
언니네이발관	bandMember	이석원	o
원더걸스	bandMember	안소희	o
조나스_브라더스	bandMember	조_조너스	o
쥬얼리	bandMember	조민아	o
컬러스_(음악_그룹)	bandMember	강인원_(가수)	o
퀸스_오브_더_스톤_에이지	bandMember	존_폴_존스_(음악가)	o
견훤	battle	공산_동수_전투	o
대한민국_국방부	battle	베트남_전쟁	o
미쓰이_그룹	battle	제2차_세계_대전	x
소련군	battle	흥남_철수_작전	o
안도_리키치	battle	제2차_세계_대전	o
알렉산드로스_3세_메가스	battle	가우가멜라_전투	o
알샤바브_(리야드)	battle	소말리아_내전	x
야하라_히로미치	battle	오키나와_전투	o
어니스트_헤밍웨이	battle	카포레토_전투	x
에르네스트_르낭	battle	프로이센-프랑스_전쟁	o
영국군	battle	다이너모_작전	o
오다_노부나가	battle	세키가하라_전투	o
유비	battle	오초칠국의_난	x
이순신	battle	사천_해전	o
제임스_롱스트리트	battle	서부_전선_(제1차_세계_대전)	o
조지_5세	battle	제1차_세계_대전	o
칼_12세	battle	나르바_전투_(1700년)	o
켄_로치	battle	스페인_내전	o
포르쉐	battle	제2차_세계_대전	x
훌라구	battle	아인잘루트_전투	x
MBC_서울국제가요제	channel	문화방송	o
결혼_7년	channel	한국방송공사	o
능력자들	channel	문화방송	o
대한민국_행복발전소	channel	한국방송공사	o
더_엑스_팩터	channel	폭스_방송	o
명작_스캔들	channel	한국방송공사	o
모두_다_김치	channel	문화방송	o
불어라_미풍아	channel	문화방송	o
브라보_신세대	channel	한국방송공사	o
비교체험_여행기_그곳에서_살아보기	channel	문화방송	o
사랑이_사랑에게	channel	SBS_파워FM	o
섀도우파이터	channel	문화방송	o
스폰지밥_네모바지	channel	니켈로디언	o
알게될거야	channel	한국방송공사	o
와라!_편의점	channel	투니버스	x
의뢰인_K	channel	한국방송공사	o
정글피쉬	channel	한국방송공사	o
죠니_브라보	channel	폭스_방송	o
파워퍼프걸	channel	폭스_방송	o
호보_(드라마)	channel	문화방송	o
강희제	child	건륭제	o
교황_그레고리오_7세	child	콘라트_3세	x
교황_니콜라오_5세	child	루키우스_안나이우스_세네카	o
김창완	child	김창익	o
김형준_(1987년)	child	김세현_(야구_선수)	o
김희철_(가수)	child	김정모	o
나카오카_신타로	child	도쿠가와_요시노부	o
닌켄_천황	child	겐조_천황	o
다윗	child	베드로	x
당_무종	child	정덕제	x
대한제국_고종	child	조선_정조	o
루지에로_2세	child	하인리히_6세	o
루트비히_판_베토벤	child	프란츠_슈베르트	o
마티아스	child	루돌프_2세	o
마티아스	child	페르디난트_2세	o
마희성	child	마희범	o
메이지_천황	child	다이쇼_천황	o
보두앵_(벨기에)	child	보두앵_5세_(예루살렘)	x
사르타크	child	베르케_칸	x
사이고_다카모리	child	오쿠보_도시미치	o
사카모토_류이치	child	마츠다_류헤이	o
성화제	child	조선_효종	x
숭덕제	child	조선_세조	x
스즈키_나나	child	나나_(가수)	x
에드워드_3세	child	제1대_요크_공작_랭글리의_에드먼드	o
오키타_소지	child	도도_헤이스케	x
유거	child	전한_애제	o
유비	child	조조	o
잉마르_베리만	child	잉리드_툴린	o
전한_무제	child	압델무멘_자부	x
전한_무제	child	전한_소제_(8대)	o
정철	child	송익필	o
제임스_먼로	child	윌리엄_헨리_해리슨	o
조_큐버트	child	애덤_큐버트	o
조선_예종	child	조선_성종	o
조선_정조	child	대한제국_순종	o
조선_태조	child	정도전	o
조선_태조	child	조선_선조	o
조선_태종	child	동치제	x
존_(잉글랜드)	child	필리프_2세_(프랑스)	o
켄_그리피_1세	child	켄_그리피_주니어	o
테오도시우스_1세	child	손권	x
프리드리히_빌헬름_1세_(1620년)	child	아우구스투스	x
플라톤	child	알렉산드로스_3세_메가스	x
헌강왕	child	효공왕	o
황기영	child	황비홍	o
후트그투_칸_쿠살라	child	원_영종_(10대)	o
흥덕왕	child	애장왕	x
49제	director	이영우_(야구인)	o
YMCA_야구단	director	김현석_(축구인)	o
김의_전쟁	director	임상수	o
매트릭스_(영화)	director	더_워쇼스키스	o
무간도	director	김동원_(1884년)	x
미쓰_홍당무	director	이경미	o
박하사탕	director	봉준호	o
베테랑_(영화)	director	블라디미르_페트코비치	x
보통소년	director	박성훈_(야구_선수)	x
시라노;_연애조작단	director	김현석_(축구인)	o
갈대	division	세균	x
군네라과	division	속씨식물	o
꼬리고사리과	division	양치류	o
나방	division	곤충	o
단문류	division	곤충	o
돌말류	division	진핵생물	x
디메아투스속	division	피낭동물	o
딱따구리목	division	아프리카오색조류	o
딱정벌레목	division	곤충	o
마황문	division	겉씨식물	o
말즘	division	동물	o
말피기목	division	속씨식물	o
모니미아과	division	속씨식물	o
베르베리돕시스과	division	속씨식물	o
복숭아	division	가지_(식물)	o
부등편모조류	division	돌말류	o
비비아니아과	division	속씨식물	o
산석류과	division	속씨식물	o
엑스카바타	division	진핵생물	x
유시아강	division	곤충	o
윤조강	division	선태식물	o
장미군	division	속씨식물	o
주발버섯류	division	균계	o
칼딜리네아과	division	세균	o
털곰팡이목	division	접합균류	o
하르펠라목	division	균계	o
협죽도과	division	속씨식물	o
훕바르디아속	division	속씨식물	o
고려_공민왕	dynasty	원나라	?
고려_공양왕	dynasty	조선	?
고려_원종	dynasty	고려	?
고려_원종	dynasty	원나라	?
고려_충정왕	dynasty	원나라	?
대한제국_고종	dynasty	조선	?
명성황후	dynasty	조선	?
북송_인종	dynasty	북송	?
아유르시리다르_빌레그트_칸	dynasty	원나라	?
원_성종	dynasty	명나라	?
조선_성종	dynasty	원나라	?
조선_세종	dynasty	대한민국	?
조선_숙종	dynasty	조선	?
조선_철종	dynasty	조선	?
조선_태종	dynasty	고려	?
조선_헌종	dynasty	조선	?
참회왕_에드워드	dynasty	프랑스군	?
천명제	dynasty	조선	?
쿠빌라이_칸	dynasty	시리아	?
토구스_테무르_우스칼_칸	dynasty	명나라	?
가야역_(한국철도공사)	era	가야	?
경주시	era	신라	?
경주역사유적지구	era	신라	?
공주시	era	백제	?
김유신	era	백제	?
나라_현	era	신라	?
대왕의_꿈	era	백제	?
백제역사유적지구	era	백제	?
범일역_(한국철도공사)	era	가야	?
부인사	era	신라	?
삼국지	era	고구려	?
삼도봉_(민주지산)	era	백제	?
서호	era	백제	?
수원_화성	era	조선	?
신라	era	고구려	?
연개소문	era	신라	?
연남생	era	신라	?
오카자키_성	era	에도_막부	?
임휴사	era	고려	?
태왕사신기	era	고구려	?
가리야목	family	카르디옵테리스과	o
감탕나무	family	필로노마과	o
개미	family	흰개미	o
검은담비	family	스컹크	o
게르프쥐여우원숭이	family	작은쥐여우원숭이	o
곤충	family	호랑나비상과	o
굴	family	흰개미	o
꼴뚜기과	family	살오징어아과	o
나도바랭이아과	family	단토니아아과	o
노랑발안테키누스	family	땃쥐류	o
노래미	family	쥐노래미	o
니그레스켄테스절	family	비발바리아아속	o
님바수달뒤쥐	family	애기수달뒤쥐속	o
다람쥐	family	우는토끼	o
달납줄개	family	납줄개속	o
독수리	family	매	o
동물	family	재규어	x
드릴_(동물)	family	개코원숭이	o
딱따구리목	family	쥐새과	o
땃쥐목	family	아프리카두더지땃쥐류	o
로리스	family	유인원	o
말피기목	family	버드나무과	o
망토고함원숭이	family	고함원숭이	o
매실나무	family	살구나무	o
몽구스	family	쿠시만스속	o
무환자나무목	family	소태나무과	o
미루나무	family	버즘나무	o
바다가마우지	family	쇠가마우지	o
바위너구리	family	바위너구리과	o
버지니아주머니쥐	family	코요테	o
북극곰	family	큰곰	o
불독개미아과	family	공룡개미	o
붉은머리타마린	family	타마린	o
비버	family	날다람쥐족	o
비버	family	카피바라	o
사슴	family	양	o
사슴풍뎅이	family	사슴풍뎅이속	o
사헬란트로푸스	family	호모_하빌리스	o
살구나무	family	자두	o
상추	family	민들레	o
소나무속	family	잎갈나무속	o
스라소니속	family	카라칼속	o
쌍떡잎식물	family	아욱과	o
아프리카오릭스	family	긴칼뿔오릭스	o
아프리카코끼리	family	아프리카코끼리속	o
알락나방상과	family	굴벌레나방상과	o
앵두나무	family	모과나무	o
양추아노사우루스	family	메트리아칸토사우루스과	o
오갈피나무	family	팔손이	o
오스트레일리아청개구리속	family	왕청개구리	o
왜가리	family	매	o
유인원	family	개코원숭이	o
작은사슴	family	사슴	o
참나무속	family	유인원	x
참복과	family	거북복과	o
참새목	family	아메리카솔새과	o
참수리	family	흰꼬리수리	o
청서번티기	family	청서번티기속	o
코아후일라케라톱스	family	카스모사우루스아과	o
큰뿔사슴	family	사슴	o
파랑새목	family	벌잡이새류	o
팔손이	family	두릅나무	o
팡가시우스	family	메콩메기과	o
하마	family	양	o
호모_에렉투스	family	호모_하빌리스	o
황금두더지	family	코끼리땃쥐	o
휘파람새과	family	솔새과	o
그레그_카마이클	genre	컨트리_음악	x
러브_스컬프쳐	genre	블루스	o
레이디_가가	genre	리듬_앤드_블루스	o
로니_제임스_디오	genre	블루스	o
마일린	genre	브릿팝	x
버클리_음악_대학	genre	재즈	x
보이존	genre	보이_밴드	o
본_이베어	genre	포크송	o
볼프강_아마데우스_모차르트	genre	인디_록	o
브라운_아이드_걸스	genre	리듬_앤드_블루스	o
블루_(음악_그룹)	genre	재즈	o
앤서니_키디스	genre	헤비_메탈	o
엘로	genre	네오_소울	o
유튜브	genre	헤비_메탈	x
이언_길런	genre	록_음악	o
이지_리스닝_(음반)	genre	블루스	o
조이_디비전	genre	신스팝	o
조현아	genre	재즈	o
치오도스	genre	하드코어_펑크	o
폴_데즈먼드	genre	재즈	o
1988년_동계_올림픽	isPartOf	1992년_동계_올림픽	x
1988년_하계_올림픽	isPartOf	1986년_아시안_게임	x
2010년_FIFA_월드컵	isPartOf	얼굴	x
2012년_하계_올림픽_펜싱_남자_플뢰레_단체	isPartOf	1896년_하계_올림픽_체조_남자_철봉	x
2014년_FIFA_월드컵_결승전	isPartOf	FIFA_월드컵	x
AFC_본머스	isPartOf	리버풀_FC	x
CS_마리티무	isPartOf	레알_마드리드_CF	x
FC_디나모_키예프	isPartOf	FC_샬케_04	x
FC_바이에른_뮌헨	isPartOf	맨체스터_시티_FC	x
FC_빅토리아_플젠	isPartOf	AC_스파르타_프라하	x
FC_빌	isPartOf	맨체스터_유나이티드_FC	x
FC_샤흐타르_도네츠크	isPartOf	FC_드니프로_드니프로페트로우스크	x
FC_제니트_상트페테르부르크	isPartOf	FC_서울	x
FC_포르투	isPartOf	비토리아_FC	x
FK_부두치노스트_포드고리차	isPartOf	ACF_피오렌티나	x
FK_부두치노스트_포드고리차	isPartOf	발렌시아_CF	x
RC_스트라스부르	isPartOf	올랭피크_리옹	x
SS_라치오	isPartOf	UC_삼프도리아	x
UEFA_유로_2004	isPartOf	FIFA_컨페더레이션스컵	x
UEFA_유로_2008	isPartOf	UEFA_유로_2012	x
가니메데_(위성)	isPartOf	목성	x
가와사키_시	isPartOf	부천시	x
가재	isPartOf	굴	x
가지예보	isPartOf	무르만스크_주	o
각막	isPartOf	눈썹	x
갈산역_(인천)	isPartOf	인천_도시철도	x
갈색	isPartOf	머리	x
강남구	isPartOf	영동대로	x
강서구_(서울특별시)	isPartOf	거제시	o
강서구_(서울특별시)	isPartOf	목동_(서울)	o
개성특급시	isPartOf	아라비아_반도	x
경기고등학교	isPartOf	하버드_대학교	o
경상남도	isPartOf	황해도	o
경신고등학교_(서울)	isPartOf	고려대학교	o
경주시	isPartOf	월성원자력발전소	o
경주시	isPartOf	충주시	o
경희대학교	isPartOf	한림대학교	o
고창_전투	isPartOf	공산_동수_전투	x
골든_글로브상	isPartOf	고야상	x
골든_글로브상	isPartOf	아카데미_음악상	x
공주시	isPartOf	익산시	o
광산구	isPartOf	북구_(포항시)	o
구로구	isPartOf	경인선	o
구르마_현	isPartOf	코몽자리_현	o
구이린_시	isPartOf	저우산_시	o
국립부여박물관	isPartOf	국립중앙박물관	o
국제_기독교_대학	isPartOf	에든버러_대학교	x
군포시	isPartOf	북구_(포항시)	o
귀	isPartOf	굿펠로우나무타기캥거루	x
귀	isPartOf	노새	x
귀	isPartOf	발	x
귀	isPartOf	팔	x
규슈	isPartOf	아마미_제도	o
그라나다	isPartOf	살라망카	o
그래미상	isPartOf	아메리칸_뮤직_어워드	x
그리니치빌리지	isPartOf	할렘	o
그리스	isPartOf	고대_아테네	o
그리스	isPartOf	스칸디나비아	x
그리스	isPartOf	키클라데스_제도	o
금나라	isPartOf	동유럽	x
금정구	isPartOf	선두구동	x
기타	isPartOf	매드체스터	x
기타	isPartOf	재즈	x
기타라마	isPartOf	남부_주_(말라위)	x
긴키_지방	isPartOf	육상_경기	x
김제시	isPartOf	익산시	o
김천시	isPartOf	군위군	o
꽃	isPartOf	귀	x
꽃	isPartOf	두루미꽃	x
꽃	isPartOf	유채	x
나망간	isPartOf	시르다리야_강	o
나미비아	isPartOf	대서양	x
나우루	isPartOf	오세아니아	x
나카세케_구	isPartOf	마신디_구	o
나카세케_구	isPartOf	무코노_구	o
나카쓰_시	isPartOf	부젠_시	o
나콘랏차시마	isPartOf	사라부리	o
나파크_구	isPartOf	아무리아_구	o
남레이테_주	isPartOf	민다나오_섬	o
남아메리카	isPartOf	안데스_산맥	x
남아메리카	isPartOf	어깨	x
네브래스카_주	isPartOf	뉴멕시코_주	o
네비_구	isPartOf	키트굼_구	o
녜라무_현	isPartOf	지구	x
노르망디	isPartOf	아키텐	o
노리치	isPartOf	브리지포트	x
노벨_화학상	isPartOf	조너선_로스	x
노스캐롤라이나_주	isPartOf	웨스트버지니아_주	o
누리스탄_주	isPartOf	쿠나르_주	o
누벨아키텐	isPartOf	오베르뉴론알프	o
뉴기니_섬	isPartOf	말레이_제도	o
뉴욕	isPartOf	노워크_(코네티컷_주)	o
뉴욕	isPartOf	롱아일랜드시티	o
뉴욕	isPartOf	상파울루	o
뉴욕	isPartOf	신시내티	o
뉴욕	isPartOf	이스트할렘	o
뉴욕	isPartOf	캔자스_주	o
뉴욕_주	isPartOf	뉴멕시코_주	o
뉴욕_주립_대학교	isPartOf	스토니브룩_대학교	o
뉴저지_주	isPartOf	버몬트_주	o
뉴질랜드	isPartOf	누벨칼레도니	o
뉴질랜드	isPartOf	오세아니아	o
다사읍	isPartOf	수성구	o
단둥_시	isPartOf	압록강	o
단원구	isPartOf	안산선	o
달	isPartOf	천지	x
달랏	isPartOf	칸_영화제	x
달팽이	isPartOf	육상_경기	x
당리역	isPartOf	부산_도시철도	x
대구고등학교	isPartOf	영남대학교	x
대구여자고등학교	isPartOf	이화여자대학교	o
대전광역시	isPartOf	평안도	o
대한민국	isPartOf	유럽_연합	o
대한민국_예비군	isPartOf	대한민국_국군	x
대한민국_체육청소년부	isPartOf	대한민국_문화관광부	x
대한민국_행정안전부	isPartOf	대한민국_국민안전처	x
덕양구	isPartOf	고려대학교	o
데니즐리_주	isPartOf	우샤크_주	o
데니즐리_주	isPartOf	이스파르타_주	o
데르나_주	isPartOf	알와하트_주	o
데바르_시	isPartOf	자야스_시	o
델라웨어_주	isPartOf	매사추세츠_주	o
델라웨어_주	isPartOf	펜실베이니아_주	o
델리	isPartOf	라호르_성	x
도미니카_공화국	isPartOf	터크스_케이커스_제도	x
도봉구	isPartOf	면목동	o
도스박스	isPartOf	윈도우_9x	x
도쿄_대학	isPartOf	산마르코스_국립_대학교	x
독일	isPartOf	알자스-로렌	x
독일	isPartOf	추축국	x
독일_사회민주당	isPartOf	독일_독립사회민주당	x
동다바오_주	isPartOf	동미사미스_주	x
동대문구	isPartOf	한국농촌경제연구원	o
동부_주_(우간다)	isPartOf	키룬도_주	x
동아나톨리아_지역	isPartOf	지중해	x
두덩뼈	isPartOf	앞어금니	x
드로키아_구	isPartOf	돈두셰니_구	o
등	isPartOf	목	x
등	isPartOf	허리	x
라도비시_시	isPartOf	바실레보_시	o
라스크루시스	isPartOf	와이오밍_주	o
라오_인민혁명당	isPartOf	베트남_공산당	x
라이프치히_대학교	isPartOf	빈_대학교	x
랜싱	isPartOf	효모	x
런던	isPartOf	시티오브런던	o
런던	isPartOf	잭_더_리퍼	x
런던	isPartOf	코펜하겐	o
런던	isPartOf	홀리루드_궁전	o
레알_사라고사	isPartOf	레알_마드리드_CF	x
레온_왕국	isPartOf	신성_로마_제국	x
레이테_주	isPartOf	민다나오_섬	o
로마	isPartOf	북아메리카	o
로테르담	isPartOf	라인_강	o
롭부리_주	isPartOf	나콘나욕_주	o
롱아일랜드	isPartOf	뉴욕_주립_대학교	x
롱아일랜드	isPartOf	코네티컷_주	o
루블린_주	isPartOf	우치_주	o
루이지애나_주	isPartOf	앨라배마_주	o
리베레츠_주	isPartOf	우스티_주	o
리베레츠_주	isPartOf	중앙보헤미아_주	o
리우데자네이루	isPartOf	대서양	o
리우데자네이루_주	isPartOf	미나스제라이스_주	o
리칠랜드_군_(사우스캐롤라이나_주)	isPartOf	사우스캐롤라이나_주	o
린셰핑	isPartOf	스톡홀름	o
마다바_주	isPartOf	요르단_강	o
마드리드	isPartOf	툴루즈	o
마라차_구	isPartOf	아주마니_구	o
마르딘_주	isPartOf	디야르바키르_주	o
마신디_구	isPartOf	불리사_구	o
마이애미	isPartOf	잭슨빌_(플로리다_주)	o
마이크로소프트_액세스	isPartOf	마이크로소프트_오피스	x
마투그로수_주	isPartOf	아마조나스_주	o
마투그로수_주	isPartOf	파라_주_(브라질)	o
마틴즈빌_(인디애나_주)	isPartOf	인디애나폴리스	o
마하사라캄	isPartOf	문_강	o
마하칼리_구	isPartOf	세티_구	o
만안구	isPartOf	삼영운수	o
말리	isPartOf	베냉	o
매사추세츠_공과대학교	isPartOf	조지아_공과대학교	o
맥_(동물)	isPartOf	마이크로소프트_윈도우	x
먀오족	isPartOf	홍_강	x
메스케티	isPartOf	아할치헤	o
메이저_리그_베이스볼	isPartOf	아메리카	x
메이저_리그_베이스볼	isPartOf	야구	x
메인_주	isPartOf	뉴잉글랜드	o
메카	isPartOf	다마스쿠스	o
멕시코시티	isPartOf	미초아칸_주	o
멜라키_구	isPartOf	메나베_구	o
몐주_시	isPartOf	청두_시	o
모던휘그당	isPartOf	공화당_(미국)	x
모란봉구역	isPartOf	평양직할시	o
모리오카_시	isPartOf	센다이_시	o
모세혈관	isPartOf	정맥	x
모스크바	isPartOf	런던_정치경제대학교	x
목	isPartOf	암	x
목원대학교	isPartOf	감리교신학대학교	o
몬_주	isPartOf	양곤_관구	o
몬태나_주	isPartOf	와이오밍_주	o
몬테네그로	isPartOf	토바고_섬	x
몬트리올	isPartOf	밴쿠버	o
몸통	isPartOf	피부	x
무장친위대	isPartOf	히틀러_청소년단	x
묵다한_주	isPartOf	마하사라캄_주	o
문산읍_(파주시)	isPartOf	판문역	x
물고기	isPartOf	백해	x
물고기	isPartOf	임진강	x
미국	isPartOf	그린란드	x
미국	isPartOf	멕시코_만	o
미국	isPartOf	워싱턴_주	o
미국	isPartOf	유럽	o
미국	isPartOf	텍사스_주	o
미국_국토안보부	isPartOf	대한민국_법무부	x
미군	isPartOf	제2보병사단_(미국)	x
미네소타_주	isPartOf	캘리포니아_주	o
미시간_주립_대학교	isPartOf	코넬_대학교	o
미시시피_주	isPartOf	루이지애나_주	o
미시시피_주	isPartOf	인디애나_주	o
미주리_주	isPartOf	펜실베이니아_주	o
미티아나_구	isPartOf	부코만심비_구	o
민주사회당_(독일)	isPartOf	미국_하원	x
민진당_(일본)	isPartOf	건국당	x
밀워키	isPartOf	애틀랜타	o
바그다드	isPartOf	티그리스_강	o
바그마티_구	isPartOf	자낙푸르_구	o
바르샤바	isPartOf	비스와_강	o
바스노르망디	isPartOf	오트노르망디	o
바실란_주	isPartOf	칼리만탄우타라_주	o
바우카우_현	isPartOf	라우텡_현	o
박쥐	isPartOf	피부	x
반여농산물시장역	isPartOf	부산_도시철도	x
발루치스탄	isPartOf	신드_주	o
발루치스탄_주	isPartOf	시스탄오발루체스탄_주	x
발베르데_주	isPartOf	엘리아스피냐_주	o
발칸_반도	isPartOf	목성	x
배구	isPartOf	배드민턴	x
배드민턴	isPartOf	배구	x
배서스트_(뉴사우스웨일스_주)	isPartOf	뉴사우스웨일스_주	o
벌지_전투	isPartOf	서부_전선_(제1차_세계_대전)	x
범게	isPartOf	게	x
베누에_주	isPartOf	에도_주	o
베니_주	isPartOf	오루로_주	o
베르겐아우프뤼겐	isPartOf	뤼겐_섬	o
베스테르보텐_주	isPartOf	노르보텐_주	o
벨기에	isPartOf	노르트라인베스트팔렌_주	o
벨라루스	isPartOf	흑해	o
보리멸	isPartOf	물고기	x
보수당_(영국)	isPartOf	얼스터_연합주의자당	x
보수당_(영국)	isPartOf	중앙당_(핀란드)	x
보이오티아_현	isPartOf	에비아_현	o
보퍼트_해	isPartOf	오호츠크_해	o
볼리비아	isPartOf	안데스_산맥	o
봉평면	isPartOf	용평면	o
봉화읍	isPartOf	영덕군	o
부등편모조류	isPartOf	균계	x
부르고뉴	isPartOf	나바라_지방	x
부산진구	isPartOf	중앙대로_(부산)	o
부셰니_구	isPartOf	루쿵기리_구	o
부코만심비_구	isPartOf	셈바불레_구	o
북수리가오_주	isPartOf	남수리가오_주	o
불라칸_주	isPartOf	누에바비스카야_주	x
붕고마_현	isPartOf	서포코트_현	o
브네이브라크	isPartOf	텔아비브	o
브라질	isPartOf	동유럽	o
브라질	isPartOf	아프리카	o
브렌트우드_(로스앤젤레스)	isPartOf	노샘프턴	x
브롱아하포_주	isPartOf	아샨티_주	o
브루클린	isPartOf	코네티컷_주	o
블레인_(미네소타_주)	isPartOf	왓컴_군	o
비아위스토크	isPartOf	프셰미실	o
비엘코폴스카_주	isPartOf	우치_주	o
비옴부_주	isPartOf	키나라_주	o
비잔티움_제국	isPartOf	로마_제국	o
비텐베르크	isPartOf	할레-비텐베르크_대학교	o
빌뉴스	isPartOf	다우가프필스	o
빨강	isPartOf	머리	x
쁘라찐부리_주	isPartOf	나콘나욕_주	o
사과나무	isPartOf	머리	x
사루후쓰_촌	isPartOf	소야	x
사마나_주	isPartOf	산토도밍고_주	o
사완_현	isPartOf	이리_(펜실베이니아_주)	x
사우스요크셔_주	isPartOf	랭커셔_주	o
사카테카스_주	isPartOf	텍사스_주	o
사할린_섬	isPartOf	코만도르스키예_제도	o
사할린_주	isPartOf	홋카이도	x
산타엘레나_주	isPartOf	엘오로_주	o
산후안_주_(아르헨티나)	isPartOf	페라비아_주	x
상록구	isPartOf	철원군_(남)	o
상파울루	isPartOf	서울특별시	o
상하이_시	isPartOf	베이징_대학	o
상하이_시	isPartOf	스톡홀름	x
상하이_시	isPartOf	충칭_시	o
새턴상	isPartOf	아카데미_여우조연상	x
서구_(광주광역시)	isPartOf	영도구	o
서대문구	isPartOf	신영동_(서울)	x
서마케도니아_주	isPartOf	중앙그리스_주	o
서머싯_주	isPartOf	글로스터셔_주	o
서벵골_주	isPartOf	안드라프라데시_주	o
서벵골_주	isPartOf	차티스가르_주	o
서부_주_(우간다)	isPartOf	프와니_주	o
서부마운틴코아티	isPartOf	안데스_산맥	x
서울대학교	isPartOf	인하대학교	o
서울성경신학대학원대학교	isPartOf	합동신학대학원대학교	o
서포모제_주	isPartOf	실롱스크_주	o
선양_시	isPartOf	쓰촨_성	o
선츠_현	isPartOf	숴저우_시	o
성남시	isPartOf	안산시	o
성동구	isPartOf	동부간선도로	x
성동구	isPartOf	서울숲	o
성북구	isPartOf	노원구	o
성산구	isPartOf	거제시	o
세인트루시아	isPartOf	서인도_연방	o
세인트루이스	isPartOf	뉴올리언스	o
셰르부르옥트빌	isPartOf	캉	o
셰퉁먼_현	isPartOf	지구	x
소	isPartOf	양	x
소노라_주	isPartOf	뉴멕시코_주	o
소닉_R	isPartOf	소닉_드리프트	x
소비에트_연방_중앙집행위원회	isPartOf	붉은_군대	x
소순다_열도	isPartOf	말레이_제도	o
손발톱	isPartOf	검정	x
송정공원역	isPartOf	광주_도시철도	x
솽류_구	isPartOf	바오딩_시	o
쇠데르만란드	isPartOf	외스테르예틀란드	o
수영구	isPartOf	연제구	o
수원시	isPartOf	평안남도	o
수정역	isPartOf	부산_도시철도	x
숙명여자대학교	isPartOf	대경대학교	o
스노_섬	isPartOf	사우스셰틀랜드_제도	o
스리랑카	isPartOf	솔로몬_제도	o
스톡턴_(캘리포니아_주)	isPartOf	1976년_하계_올림픽	x
스투데니차니_시	isPartOf	일린덴_시	o
스페인	isPartOf	브리튼_제도	o
스페인	isPartOf	아_카펠라	x
스페인	isPartOf	제노바_공화국	o
시기리_(기니)	isPartOf	나이저_강	o
시노프_주	isPartOf	카라뷔크_주	o
시민민주당	isPartOf	독일_연방상원	x
시베리아	isPartOf	눈_(해부학)	x
시애틀	isPartOf	유타_주	o
시애틀	isPartOf	포틀랜드_(오리건_주)	o
시카고	isPartOf	멜버른	o
시카고	isPartOf	아시아	o
실비치	isPartOf	롱비치_(캘리포니아_주)	o
싱부리_주	isPartOf	나콘빠톰_주	o
싱카왕	isPartOf	폰티아낙	o
아라우카_주	isPartOf	보야카_주	o
아메리카	isPartOf	버지니아_주	x
아메리칸_하키_리그	isPartOf	내셔널_하키_리그	o
아무리아_구	isPartOf	리라_구	o
아시아	isPartOf	버킷_리스트:_죽기_전에_꼭_하고_싶은_것들	o
아시아	isPartOf	포스트_타워	x
아시아_개발_은행	isPartOf	국제_통화_기금	x
아이다호_주	isPartOf	워싱턴_주	o
아주대학교	isPartOf	숭실대학교	o
아체_주	isPartOf	수마트라_섬	o
아카데미_각본상	isPartOf	아카데미_작품상	o
아카데미상	isPartOf	아카데미_주제가상	x
아카데미상	isPartOf	퓰리처상	x
아칸소_주	isPartOf	켄터키_주	o
아타코라_주	isPartOf	알리보리_주	o
아파크_구	isPartOf	오얌_구	o
아프리카코끼리	isPartOf	코	x
안나푸르나_산	isPartOf	히말라야_산맥	x
안드로이드_(운영_체제)	isPartOf	우분투_(운영_체제)	x
안바르_주	isPartOf	나자프_주	o
안산_(서울)	isPartOf	이화여자대학교	o
안티폴로	isPartOf	리살_주	o
암	isPartOf	라바트	x
암비테	isPartOf	마드리드	o
암스테르담	isPartOf	코펜하겐	o
앙카라_주	isPartOf	볼루_주	o
애너하임	isPartOf	로스앤젤레스	o
애리조나_주	isPartOf	미시간_주	o
애선스_(오하이오_주)	isPartOf	앨라배마_주	o
앨버커키	isPartOf	오하이오_주	o
앵커리지	isPartOf	와실라	o
양동시장역	isPartOf	광주_도시철도	o
양산시	isPartOf	밀양시	o
어깨	isPartOf	관절	x
어깨	isPartOf	허리	x
어깨	isPartOf	허파	x
어퍼웨스트사이드	isPartOf	센트럴_파크	o
언더우드_국제대학	isPartOf	연세대학교	o
얼굴	isPartOf	출혈	x
에든버러	isPartOf	런던	o
에든버러_페스티벌_프린지	isPartOf	에든버러_국제_페스티벌	o
에리스_(왜행성)	isPartOf	명왕성	x
에볼라바이러스	isPartOf	에볼라_출혈열	x
에콰도르	isPartOf	이사벨라_섬	o
에히메_대학	isPartOf	니혼_대학	o
엔도_전투	isPartOf	제다이의_귀환	x
엘오로_주	isPartOf	아수아이_주	o
엘이에로_섬	isPartOf	카나리아_제도	o
엘패소	isPartOf	시우다드후아레스	o
여우원숭이	isPartOf	머리	x
연안군	isPartOf	황해도	o
영국	isPartOf	말라야_연방	o
영국	isPartOf	트리스탄다쿠냐_제도	o
영등포구	isPartOf	탕산_시	x
영암군	isPartOf	화순군	o
예루살렘	isPartOf	성전기사단	x
예루살렘	isPartOf	예호람	x
예루살렘	isPartOf	파티마_(포르투갈)	x
예산군	isPartOf	천안시	o
예천군	isPartOf	한국폴리텍6대학	x
오드프랑스	isPartOf	바스노르망디	o
오리건_주	isPartOf	미주리_주	o
오리건_주	isPartOf	산타페_가도	o
오버우어젤	isPartOf	프랑크푸르트암마인	o
오베르뉴	isPartOf	바스노르망디	o
오스트레일리아	isPartOf	토러스_해협_제도	o
오크니차_구	isPartOf	르슈카니_구	o
오클라호마_주	isPartOf	뉴멕시코_주	o
오클랜드_(뉴질랜드)	isPartOf	펜실베이니아_주	x
오트피레네_주	isPartOf	나바라_지방	o
오폴레_주	isPartOf	비엘코폴스카_주	o
오하이오_대학교	isPartOf	버지니아_대학교	o
오하이오_주	isPartOf	켄터키_주	o
옥스퍼드_대학교	isPartOf	맨체스터_대학교	o
옥스퍼드_대학교	isPartOf	프린스턴_고등연구소	x
옥탸브리스코이레볼류치_섬	isPartOf	세베르나야제믈랴_제도	o
옹진군_(인천광역시)	isPartOf	서산시	o
옹진군_(인천광역시)	isPartOf	해남군	o
와이오밍_주	isPartOf	노스플랫_강	o
완주군	isPartOf	논산시	o
외이스튀를란드	isPartOf	메인_주	x
외이스튀를란드	isPartOf	발칸_반도	x
외이스튀를란드	isPartOf	흑해	x
요시다_정	isPartOf	사쿠라지마_섬	o
요크	isPartOf	데이비스_(캘리포니아_주)	x
용산구	isPartOf	용산동_(서울)	o
우산이끼문	isPartOf	목	x
우지체	isPartOf	로즈니차	o
우창_구	isPartOf	하얼빈_시	o
울주군	isPartOf	청도군	o
움살랄	isPartOf	알구와리야	o
워링턴	isPartOf	보르도	o
워싱턴_주	isPartOf	아이다호_주	o
윈디_윌로우스의_앤	isPartOf	빨간_머리_앤	x
유라시아	isPartOf	수에즈	x
유럽	isPartOf	로키_산맥	o
유럽	isPartOf	지구	x
유럽_연합	isPartOf	유럽_의회	o
유성구	isPartOf	광주시_(경기도)	o
유타_대학교	isPartOf	브리검영_대학교	o
은코타코타	isPartOf	말라위_호	o
의왕시	isPartOf	군포시	o
의정부시	isPartOf	양주시	o
이르비드_주	isPartOf	발카_주	o
이반다_구	isPartOf	셰마_구	o
이부스키_시	isPartOf	마쿠라자키_시	o
이오_섬	isPartOf	사이판_섬	o
이타키_섬	isPartOf	이오니아_제도	o
이탈리아	isPartOf	북아메리카	o
익산시	isPartOf	하버드_대학교	o
인도	isPartOf	복음성가	x
인천하이텍고등학교	isPartOf	한라대학교	x
일렉트로팝	isPartOf	신스팝	x
일리노이_주	isPartOf	오클라호마_주	o
일리노이_주	isPartOf	지구	x
일본	isPartOf	네덜란드령_동인도	x
일본	isPartOf	삼바	x
일본	isPartOf	아시아	o
자궁경부암	isPartOf	암	x
자주	isPartOf	털	x
잘츠부르크	isPartOf	바이에른_주	o
전어	isPartOf	물고기	x
전주시	isPartOf	여주시	o
정선	isPartOf	황해북도	x
정읍시	isPartOf	단국대학교	o
제1차_상하이_사변	isPartOf	중일_전쟁	x
제8기계화보병사단_(대한민국)	isPartOf	해군육전대_(일본_제국)	x
제네바_대학교	isPartOf	베를린_훔볼트_대학교	x
제주시	isPartOf	제주시_탐라도서관	o
조지아_(국가)	isPartOf	흑해	o
중구_(서울특별시)	isPartOf	한강	o
중구역	isPartOf	붉은별역	x
중국국민당	isPartOf	국민혁명군	x
중랑구	isPartOf	노원구	o
중러우_구	isPartOf	창저우_시_(허베이_성)	o
중앙아시아	isPartOf	동유럽	o
중앙아시아	isPartOf	유라시아	x
중화민국	isPartOf	유라시아	x
중화인민공화국	isPartOf	아랍_연합_공화국	o
지무나이_현	isPartOf	아러타이_시	o
지브롤터_해전	isPartOf	네덜란드_독립_전쟁	x
지중해	isPartOf	브리튼_제도	x
진주	isPartOf	전라도	x
진주민란	isPartOf	제너럴셔먼호_사건	x
징거미	isPartOf	물고기	x
징안_구	isPartOf	상하이_시	o
징저우_시	isPartOf	충칭_시	x
쯔중_현	isPartOf	루저우_시	o
차_(음료)	isPartOf	패혈증	x
차슈카_시	isPartOf	데미르카피야_시	o
차슈카_시	isPartOf	크루셰보_시	o
창사_시	isPartOf	쿤밍_시	o
창원시	isPartOf	김해시	o
청각_장애	isPartOf	지적_장애	x
초록	isPartOf	검정	x
초록	isPartOf	남색	x
초코_주	isPartOf	칼다스_주	o
축구	isPartOf	레기오날리가	x
충남대학교	isPartOf	동국대학교	o
치앙라이_주	isPartOf	치앙마이_주	o
칠레	isPartOf	엘키_현	o
칠레령_남극_지역	isPartOf	남극	x
카가얀_주	isPartOf	북일로코스_주	o
카게라_주	isPartOf	루콰_주	o
카게라_주	isPartOf	응고지_주	x
카롱가	isPartOf	말라위_호	o
카루지_주	isPartOf	키룬도_주	o
카르타고	isPartOf	알프스_산맥	o
카바다르치_시	isPartOf	데미르카피야_시	o
카보베르데	isPartOf	상비센트_섬	o
카세세_구	isPartOf	키발레_구	o
카세아	isPartOf	위턱뼈	x
카셰우_주	isPartOf	오이우_주	o
카이세리_주	isPartOf	기레순_주	o
카탄두아네스_주	isPartOf	북카마리네스_주	x
칼리닌그라드	isPartOf	괴팅겐_대학교	x
캄퐁참_주	isPartOf	스퉁트렝_주	o
캐나다	isPartOf	일본	o
캐나다	isPartOf	타이완	o
캐나다	isPartOf	포클랜드_제도	o
캐나다	isPartOf	폴란드	o
캔자스_대학교	isPartOf	엑서터_대학교	o
캔자스_주	isPartOf	하와이_주	o
커빙턴_(루이지애나_주)	isPartOf	킹_군_(워싱턴_주)	o
컬럼비아_(사우스캐롤라이나_주)	isPartOf	세인트루이스	o
컬럼비아_(사우스캐롤라이나_주)	isPartOf	컬럼비아_우주왕복선	o
컬럼비아_대학교	isPartOf	연세대학교	o
케임브리지_대학교	isPartOf	하버드_대학교	o
코	isPartOf	머리뼈	x
코	isPartOf	손가락	x
코	isPartOf	하양	x
코네티컷_주	isPartOf	매사추세츠_주	o
코린티아_현	isPartOf	메시니아_현	o
코모도_섬	isPartOf	누사틍가라티무르_주	o
코바리마_현	isPartOf	누사틍가라티무르_주	x
코아우일라_주	isPartOf	할리스코_주	o
코펜하겐	isPartOf	독일_국방군	x
쾰른	isPartOf	부에노스아이레스	o
쿤디나마르카_주	isPartOf	우일라_주_(콜롬비아)	o
퀵실버_(마블_코믹스)	isPartOf	MacOS	x
퀸스	isPartOf	텍사스_대학교_오스틴	o
크라이스트처치	isPartOf	세인트마이클_교구	x
크레타	isPartOf	로도스_섬	o
클루지_주	isPartOf	아라드_주	o
클리블랜드	isPartOf	오하이오_주립_대학교	o
키르셰히르_주	isPartOf	네브셰히르_주	o
키시너우	isPartOf	커우셰니_구	o
키체보_시	isPartOf	자야스_시	o
킬리만자로_주	isPartOf	모로고로_주	o
타이완	isPartOf	소앤틸리스_제도	o
탄산	isPartOf	이산화_탄소	x
터키	isPartOf	축구	x
털	isPartOf	개미핥기	x
털	isPartOf	노루	x
털	isPartOf	오렌지	x
털	isPartOf	종기	x
테니스	isPartOf	게이큐_본선	x
테살로니키	isPartOf	일리리아	o
텍사스_주	isPartOf	파나마_운하	x
톄링_시	isPartOf	랴오양_시	o
토아마시나_주	isPartOf	마하장가_주	o
토토니카판_주	isPartOf	수치테페케스_주	o
투페이스	isPartOf	얼굴	x
퉁더_현	isPartOf	하이난_성	x
퉁하이_현	isPartOf	위시_시	o
튀니지	isPartOf	아틀라스_산맥	o
트렌친_주	isPartOf	반스카비스트리차_주	o
트빌리시	isPartOf	다게스탄_공화국	o
파리_(프랑스)	isPartOf	펜실베이니아_대학교	o
파푸아뉴기니	isPartOf	뉴브리튼_섬	o
팔	isPartOf	골절	x
팔레스타인	isPartOf	유럽	o
팡가시난_주	isPartOf	루손_섬	o
펑청_시_(단둥_시)	isPartOf	이춘_시_(헤이룽장_성)	o
페루	isPartOf	남아메리카	o
페트로베츠_시	isPartOf	스베티니콜레_시	o
페트로베츠_시	isPartOf	쿠마노보_시	o
펜서콜라	isPartOf	멕시코_만	o
평산군	isPartOf	평부선	x
평양직할시	isPartOf	요코하마_시	o
평양직할시	isPartOf	자강도	o
포토시_주	isPartOf	라파스_주_(볼리비아)	o
포트리스_3	isPartOf	포트리스_2	x
포트무디	isPartOf	극락조자리_델타	x
포트엘리자베스	isPartOf	이스트런던	o
푸스발-분데스리가	isPartOf	라리가	x
푸아티에_전투	isPartOf	백년_전쟁	x
프라하	isPartOf	모스크바	o
프랑스	isPartOf	마스카렌_제도	o
프랑스	isPartOf	브르타뉴	o
프랑스	isPartOf	얼굴	x
프래_주	isPartOf	나콘사완_주	o
프레더릭스버그_(버지니아_주)	isPartOf	리치먼드_(버지니아_주)	o
프레스턴_노스_엔드_FC	isPartOf	노리치_시티_FC	x
프리모르스키_지방	isPartOf	홋카이도	x
프리슬란트_주	isPartOf	니더작센_주	o
프릴레프	isPartOf	벨레스_(도시)	o
플로레슈티_구	isPartOf	르슈카니_구	o
플로리나_현	isPartOf	서마케도니아_주	o
플로리다_주	isPartOf	하와이_주	o
플로리다_준주	isPartOf	플로리다_주	o
피에몬테_주	isPartOf	토스카나_주	o
필리핀	isPartOf	말루쿠_제도	o
하바롭스크_지방	isPartOf	프리모르스키_지방	o
하버드_대학교	isPartOf	매사추세츠_공과대학교	o
하양	isPartOf	눈썹	x
하얼빈_시	isPartOf	항저우_시	o
하와이기러기	isPartOf	하와이_제도	x
하이데라바드_(인도)	isPartOf	신드_주	o
하이퍼카드	isPartOf	MacOS	x
하이퐁	isPartOf	다낭	o
한국	isPartOf	충청남도	o
한반도	isPartOf	보령시	o
한반도	isPartOf	청서	x
한반도	isPartOf	홋카이도	o
할리스코_주	isPartOf	미초아칸_주	o
함경남도	isPartOf	두만강	o
항문	isPartOf	갈색	x
해리슨_(뉴저지_주)	isPartOf	뇌종양	x
해머스미스	isPartOf	시티오브런던	o
해먼드_(인디애나_주)	isPartOf	시카고	o
향산군	isPartOf	자강도	o
허파	isPartOf	뇌	x
헬싱	isPartOf	헬싱키	x
혀	isPartOf	초록	x
호위함대	isPartOf	자위함대	x
혼슈	isPartOf	간토_지방	o
홍해	isPartOf	대서양	x
홍해	isPartOf	아카바_만	x
화이트_마쉬_전투	isPartOf	미국_독립_전쟁	x
황해	isPartOf	연평도	o
회색	isPartOf	얼굴	x
흐로드나_주	isPartOf	호멜_주	x
흔들리는_마음	isPartOf	시간의_날개	x
히로시마_시	isPartOf	미조구치_겐지	x
고려여객	keyPerson	박주현_(야구_선수)	x
구글	keyPerson	세르게이_브린	o
금융결제원	keyPerson	원장	x
닌텐도	keyPerson	야마우치_히로시	o
드림웍스_애니메이션	keyPerson	톰_맥그래스	o
로켓_레코드_컴퍼니	keyPerson	엘튼_존	o
맥도널	keyPerson	바비_샌즈	x
미래엔	keyPerson	김광수_(1981년)	x
미스_유니버스	keyPerson	도널드_트럼프	o
브리지스톤	keyPerson	이시바시_쇼지로	o
삼성그룹	keyPerson	김동광	x
워너_브라더스	keyPerson	캐서린_헵번	o
일본음악저작권협회	keyPerson	사카이_이즈미	x
저스트뮤직	keyPerson	천재노창	o
제너럴_모터스	keyPerson	프랭클린_D._루스벨트	o
카툰_네트워크_스튜디오	keyPerson	리베카_슈거	o
파라마운트_픽쳐스	keyPerson	앤서니_에드워즈	o
포드_모터_컴퍼니	keyPerson	재키_윌슨	o
픽사	keyPerson	피트_닥터	o
한국방송공사	keyPerson	서혜정	o
가와바타_야스나리	knownFor	설국	o
공형진	knownFor	KBS_뉴스_9	o
구로사와_아키라	knownFor	붉은_수염	o
권상우	knownFor	기담	o
김승우	knownFor	신_귀공자	o
나폴레옹_3세	knownFor	갈리아_전기	x
니콜라이_코스테르발다우	knownFor	벡	x
다이앤_레인	knownFor	리틀_로망스	o
다카하타_이사오	knownFor	귀를_기울이면	o
레오나르도_다_빈치	knownFor	모나리자	o
로버트_캐니거	knownFor	배트맨	x
루이스_캐럴	knownFor	바텐베르크_공녀_앨리스	x
리누스_토르발스	knownFor	리눅스	o
미셸_모너핸	knownFor	미션_임파서블_3	o
박성우_(만화가)	knownFor	영_간간	o
발터_그로피우스	knownFor	데사우	o
빈센트_반_고흐	knownFor	밤의_카페_테라스	o
세르게이_디아길레프	knownFor	미하일_포킨	x
송기윤	knownFor	바람은_불어도	o
스다_마사키	knownFor	테니스의_왕자	o
스티브_피크	knownFor	리그_오브_레전드	o
시어도어_루스벨트	knownFor	브로드웨이	o
심혜진	knownFor	당신_옆이_좋아	o
아돌프_히틀러	knownFor	나의_투쟁	o
아우구스트_바이스만	knownFor	찰스_다윈	x
어니스트_헤밍웨이	knownFor	아바나	x
엄지원	knownFor	매직_(드라마)	o
에도가와_코난	knownFor	마녀_배달부_키키	o
오스카_와일드	knownFor	프로스페르_메리메	x
요하네스_케플러	knownFor	튀코_브라헤	x
월터_스콧	knownFor	프랭크_(영화)	x
윌리엄_댐피어	knownFor	뉴기니_섬	x
이고리_스트렐코프	knownFor	호를리우카	x
이언_플레밍	knownFor	치티치티뱅뱅_(영화)	o
이창동	knownFor	박하사탕	o
장_주네	knownFor	하녀들	x
제니퍼_로페즈	knownFor	웨딩드레스_(드라마)	x
제임스_마시	knownFor	맨_온_와이어	o
제임스_얼_레이	knownFor	마틴_루터_킹_주니어	x
제프_로브	knownFor	캡틴_아메리카	x
클로드_프롤로	knownFor	파리의_노트르담	o
톰_행크스	knownFor	아폴로_13	o
파울_하우서	knownFor	이반_코네프	x
하후돈	knownFor	삼국지	x
헨리크_입센	knownFor	페르_귄트	o
눈의_꽃	language	한국어	o
도라도라_영어나라	language	스페인어	o
라일로	language	영어	o
바이두백과	language	중국어	o
술의_나라	language	노르웨이어	o
신조인간_캐산	language	일본어	x
악마의_시	language	일본어	x
오토캐드	language	한국어	o
위키배움터	language	영어	x
위키백과	language	영어	o
위키백과	language	폴란드어	o
위키백과	language	한문	o
위키트래블	language	영어	o
윈도우_NT_3.5	language	한국어	o
인터내셔널_뉴욕_타임스	language	영어	o
집결호	language	영어	o
춘추좌씨전	language	광둥어	o
코리올란_서곡	language	독일어	x
포_그린_필즈	language	영어	x
하트_커넥트	language	한국어	x
광둥어	languageFamily	민난어	o
라트비아어	languageFamily	우크라이나어	o
리키아어	languageFamily	시데어	o
리키아어	languageFamily	카리아어	o
말라가시어	languageFamily	테툼어	o
백제어	languageFamily	신라어	x
벨라루스어	languageFamily	헝가리어	o
셀쿠프어	languageFamily	러시아어	o
소그드어	languageFamily	웨일스어	o
스페인어	languageFamily	독일어	o
아이누어	languageFamily	네덜란드어	x
아이누어	languageFamily	티베트어	x
일본어	languageFamily	네덜란드어	o
일본어	languageFamily	핀란드어	o
중국어	languageFamily	베트남어	o
중국어	languageFamily	불가리아어	o
중국어	languageFamily	스페인어	o
카렐리야어	languageFamily	네네츠어	o
티베트어	languageFamily	체코어	x
프랑스어	languageFamily	이디시어	o
프랑스어	languageFamily	일본어	o
프랑스어	languageFamily	체코어	o
프랑스어	languageFamily	히브리어	o
핀란드어	languageFamily	베트남어	o
하우사어	languageFamily	그리스어	x
한국어	languageFamily	몽골어	o
헝가리어	languageFamily	롬어	o
히브리어	languageFamily	링갈라어	x
히브리어	languageFamily	코이네_그리스어	o
남조선로동당	leader	조소앙	x
노동당_(영국)	leader	데이비드_캐머런	o
대한민국_국회	leader	장면	o
대한민국_법무부	leader	이사악	x
대한민국_소방방재청	leader	남상호	x
대한민국_여성가족부	leader	장면	x
대한민국_육군사관학교	leader	박준병_(1933년)	x
미군	leader	야마모토_이소로쿠	x
민주당_(미국)	leader	테오도로_피카도_미찰스키	x
민주사회를_위한_변호사_모임	leader	박원순	o
민주진보당	leader	마잉주	o
북인	leader	이황	x
사회당_(프랑스)	leader	장_조레스	x
영국군	leader	웨일스_공_찰스	x
오스트리아_연방육군	leader	프란츠_콘라트_폰_회첸도르프_백작	o
이스라엘_방위군	leader	레비_에슈콜	o
자유민주당_(일본)	leader	구리바야시_다다미치	o
자유민주당_(일본)	leader	후쿠다_야스오	o
중국국민당	leader	얀_스뮈츠	x
중화인민공화국_국무원	leader	황쥐	o
한국	leader	넬슨_신	x
한국	leader	다비드_데_헤아	x
한국	leader	마크_트웨인	x
한국	leader	변희봉	o
한국	leader	윤이상	x
한국	leader	최영의	o
한국	leader	홍범도	o
한국	leader	홍혜걸	x
FC_루빈_카잔	league	프리미어리그	o
FC_바이에른_뮌헨	league	세리에_A	o
다윈_바니	league	메이저_리그_베이스볼	o
디트로이트_타이거스	league	마이너_리그_베이스볼	o
마레크_얀쿨로프스키	league	세리에_A	o
마스부치_다쓰요시	league	센트럴_리그	o
마이애미_히트	league	사우스이스트_디비전_(NBA)	o
마이크_티어넌	league	메이저_리그_베이스볼	x
볼티모어_오리올스	league	마이너_리그_베이스볼	o
브랜치_리키	league	메이저_리그_베이스볼	x
브와제이_아우구스틴	league	엑스트라클라사	o
사이토_유키_(1988년)	league	퍼시픽_리그	o
샌프란시스코_데몬스	league	서부_콘퍼런스_(NBA)	o
세인트루이스_카디널스	league	메이저_리그_베이스볼	o
세인트루이스_카디널스	league	텍사스_리그	o
송진형	league	K리그	o
알렌_아브디치	league	K리그	x
알아흘리_(두바이)	league	프리미어리그	o
오스틴_로민	league	메이저_리그_베이스볼	o
원광대학교	league	메이저_리그_베이스볼	x
윌리_맥코비	league	메이저_리그_베이스볼	x
음보_음펜자	league	푸스발-분데스리가	x
제이슨_베이	league	메이저_리그_베이스볼	x
조_마워	league	내셔널_리그_(야구)	x
조_콜	league	북미_축구_리그	o
조바_체임벌린	league	메이저_리그_베이스볼	o
존_(잉글랜드)	league	메이저_리그_베이스볼	x
지경훈	league	프리미어리그	x
짐_아이젠라이크	league	메이저_리그_베이스볼	o
참회왕_에드워드	league	내셔널_하키_리그	x
채드_크루터	league	메이저_리그_베이스볼	o
칼초_파도바	league	세리에_A	o
텍사스_레인저스	league	프리미어리그	x
포틀랜드_팀버스	league	북미_축구_리그	o
폴_개스코인	league	세리에_A	o
스티브_브루스	managerClub	카디프_시티_FC	o
알렉스_퍼거슨	managerClub	ACF_피오렌티나	o
알렉스_퍼거슨	managerClub	리즈_유나이티드_AFC	o
알렉스_퍼거슨	managerClub	맨체스터_시티_FC	o
알렉스_퍼거슨	managerClub	에버턴_FC	o
알렉스_퍼거슨	managerClub	울버햄프턴_원더러스_FC	o
GE_제네시스_시리즈	manufacturer	제너럴_일렉트릭	x
KAI_수리온	manufacturer	국군의무사령부	x
기아_타우너	manufacturer	기아자동차	o
닛산_마치	manufacturer	닛산_자동차	o
닛산_스카이라인	manufacturer	메르세데스-벤츠	o
닷지_다코타	manufacturer	닷지	o
메르세데스-벤츠_C_클래스	manufacturer	메르세데스-벤츠	o
메르세데스-벤츠_SLR_맥라렌	manufacturer	다임러_AG	o
쉐보레_올란도	manufacturer	한국GM	o
스마트_포투	manufacturer	스마트_(자동차)	o
아우디_RS7	manufacturer	아우디	o
암트랙_뷰라이너	manufacturer	암트랙	o
찬드라얀_1호	manufacturer	사티시_다완_우주_센터	x
토요타_2000GT	manufacturer	토요타_자동차	o
포드_20M	manufacturer	포드_모터_컴퍼니	x
포드_20M	manufacturer	현대자동차	o
포르쉐_파나메라	manufacturer	폭스바겐	o
폭스바겐_비틀	manufacturer	포르쉐	o
현대_슈퍼트럭	manufacturer	대우중공업	o
현대_슈퍼트럭	manufacturer	미쓰비시후소트럭_버스	o
동탁	opponent	장제_(후한)	o
동탁	opponent	후한_헌제	o
두건덕	opponent	왕세충	x
문재인	opponent	박근혜	o
백선엽	opponent	유재흥	o
악진	opponent	조조	o
우금	opponent	장수_(후한)	o
우금	opponent	조조	o
위연	opponent	마속	o
임호균	opponent	김정수_(1962년)	o
장수_(후한)	opponent	관우	o
장수_(후한)	opponent	다윗	x
장수_(후한)	opponent	마속	o
장수_(후한)	opponent	북송_태조	o
장수_(후한)	opponent	손견	o
장수_(후한)	opponent	정극상	x
장수_(후한)	opponent	폴리테스	x
장수_(후한)	opponent	항우	x
조운_(촉한)	opponent	유비	o
항우	opponent	장수_(후한)	x
갈색발왕개미	order	벌목_(곤충)	o
개복치	order	오징어	o
거미	order	도마뱀	o
거미강	order	기생진드기상목	o
검룡류	order	후양고사우루스	o
검은반점쿠스쿠스	order	유대류	o
고래상어	order	수염고래아목	o
곤충	order	갑각류	o
곤충	order	강도래	o
곰치과	order	조기어류	o
공룡	order	조반목	o
광비원류	order	포유류	o
까불이족제비여우원숭이	order	여우원숭이	o
까치딱새류	order	새	o
꼬마주머니쥐속	order	유대류	o
나르키네과	order	연골어류	o
나무늘보	order	포유류	o
나무발발이상과	order	새	o
납작머리땃쥐	order	포유류	o
네모데르마_팅기타눔	order	갈조류	o
능구렁이	order	설치류	o
대구목	order	조기어류	o
데스마토수쿠스	order	지배파충류	o
도마뱀	order	뱀	o
도요목	order	꼬마물떼새	o
돌조개목	order	홍합	o
동갈돔과	order	조기어류	o
되새과	order	참새	o
딱정벌레목	order	물땡땡이과	o
딱정벌레목	order	지렁이	o
라이톤린상	order	포유류	o
레비아시나과	order	조기어류	o
로라이마쥐	order	비단털쥐	o
마취목	order	쌍떡잎식물	o
말벌상과	order	곤충	o
매퉁이과	order	조기어류	o
맵시벌과	order	곤충	o
메갈로사우루스	order	공룡	o
메소스티그마	order	별해캄목	o
명금류	order	참새하목	o
명주달팽이	order	복족류	o
무환자나무목	order	장미목	o
문절망둑	order	물고기	o
물고기	order	도마뱀	o
미나리목	order	산호랑나비	x
민다나오땃쥐	order	포유류	o
밤게과	order	연갑강	o
배각류	order	다지류	o
배각류	order	소각류	o
뱅가이쿠스쿠스	order	유대류	o
버마족제비오소리	order	포유류	o
범고래	order	갈매기	o
베도라치아목	order	조기어류	o
벨루사우루스	order	공룡	o
부채머리수리	order	뱀	o
사람아과	order	침팬지	o
사향고양이하목	order	하이에나	o
샛비늘치목	order	조기어류	o
설치류	order	멧밭쥐	o
섬초롱꽃	order	초롱꽃목	o
세룡	order	양서류	o
소철류	order	검룡류	x
술라웨시난쟁이쿠스쿠스	order	유대류	o
쉴리터두더지땃쥐	order	포유류	o
시노케라톱스	order	각룡류	o
신월가자미과	order	조기어류	o
십각목	order	수상새아목	o
십완상목	order	초형아강	o
쌍살벌	order	나비	o
아이젠트라우트쥐땃쥐	order	포유류	o
아켈로우사우루스	order	케라톱스	o
양볼락아목	order	조기어류	o
에티오피아멧토끼	order	포유류	o
영장류	order	곤충	o
오징어	order	상어	o
올링기토	order	포유류	o
윈난멧토끼	order	포유류	o
임마과	order	나방	o
전갱이목	order	조기어류	o
전복	order	성게류	o
조록나무과	order	프로테아목	o
주걱벌레붙이목	order	연갑강	o
주걱치목	order	농어아목	o
주청케라톱스	order	렙토케라톱스	o
준치	order	멸치	o
짧은귀주머니쥐	order	유대류	o
차오양사우루스과	order	각룡류	o
캥거루아목	order	유대류	o
코일루루스	order	공룡	o
콘도르과	order	맹금류	o
콘드리엘라_푸실라	order	진정홍조강	o
크네모필루스과	order	새	o
큰박쥐류	order	관박쥐	o
킬로돈과	order	조기어류	o
킬리만자로땃쥐	order	포유류	o
테르모프로테우스목	order	테르모프로테우스강	o
토로사우루스	order	도마뱀	o
퉁가리과	order	물고기	o
티라노사우루스과	order	공룡	o
파이오필라속	order	갈파래강	o
햄스터	order	거북	o
홍조식물	order	네마스토마목	o
JYP_엔터테인먼트	owner	브랜뉴뮤직	o
LG텔레콤	owner	LG그룹	x
간토_지방	owner	도쿄_도_교통국	x
강릉시청_축구단	owner	강원_FC	x
강변로_(경주시)	owner	경주여자고등학교	x
게이큐_본선	owner	동일본여객철도	o
게이큐_본선	owner	서일본여객철도	o
고짓코쿠_역	owner	홋카이도_여객철도	o
구글	owner	엔비디아	o
금호타이어	owner	아시아나항공	o
달리역	owner	울산공업고등학교	x
대한국민항공	owner	대한항공	x
도나우_강	owner	프랑스군	x
독일철도	owner	사노피	x
드네프르_강	owner	소련군	x
런던_개트윅_공항	owner	영국항공	o
록스타_리즈	owner	록스타_게임스	o
미스_월드	owner	미스_인터내셔널	o
밀라노_말펜사_공항	owner	알리탈리아_항공	o
사이버링크	owner	삼성그룹	x
삼성전자	owner	텍사스_인스트루먼트	x
상하이_항공	owner	샤먼_항공	x
생텍쥐페리_국제공항	owner	에어프랑스	o
서초동	owner	교보문고	x
성남시	owner	대한송유관공사	o
성남시	owner	한국토지주택공사	o
세이브존	owner	금호아시아나그룹	o
센자키_역	owner	지선_(가수)	x
센트럴_파크	owner	채드윅송도국제학교	x
소니_픽처스_엔터테인먼트	owner	사노피	x
소스포지	owner	구글	o
시로이시_시	owner	홋카이도_여객철도	o
시티오브런던	owner	스토크_시티_FC	x
신사우도서관	owner	춘천시립도서관	x
아메리칸_항공	owner	일본항공	x
아에로플로트	owner	아스타나_항공	x
아오바_역	owner	홋카이도_여객철도	o
아즈치_성	owner	오다_노부나가	x
알리안츠_아레나	owner	TSV_1860_뮌헨	o
오스트레일리아_항공	owner	콴타스_항공	o
온네나이_역	owner	홋카이도_여객철도	o
용인시청_축구단	owner	최태원_(기업인)	x
울산_현대_축구단	owner	현대오일뱅크	x
원주공항	owner	제8전투비행단_(대한민국)	x
인천_도시철도	owner	가천대학교	o
전일본공수	owner	에어아시아	x
코니카_미놀타	owner	소니	o
퀄컴	owner	엔비디아	o
파리_오를리_공항	owner	브릿_에어	o
할름스타드_BK	owner	대한민국_축구_국가대표팀	x
현풍고등학교_축구부	owner	현풍고등학교	x
홋카이도	owner	동일본_고속도로	o
히든패스_엔터테인먼트	owner	밸브_코퍼레이션	x
김영수_(1975년)	parent	김석원	x
루이_19세	parent	오스트리아의_마리_테레즈	o
발해_선왕	parent	루이_14세	x
비류왕	parent	구수왕	x
스웨덴_왕세녀_빅토리아	parent	빅토리아_(영국)	x
에드먼드_1세	parent	헨리_3세	o
에포닌	parent	가이우스_마리우스	x
엘리사_(예언자)	parent	엘리야	x
엘리자베트_폰_외스터라이히운가른_황후	parent	루이_14세	x
예수	parent	사도_요한	o
오스트리아의_마리아나	parent	보헤미아와_헝가리의_안나	x
유리_조르카에프	parent	장_조르카에프	o
윤증현	parent	이건희	o
이순신	parent	조선_선조	o
조선_단종	parent	조선_세조	o
조선_태종	parent	고려_태조	o
카를_5세	parent	프랑수아_1세_(프랑스)	o
카미스_카다피	parent	무아마르_알_카다피	o
코제트	parent	팡틴	o
효철의황후	parent	서태후	o
곽광	position	하동군	x
교황_비오_5세	position	스페인	x
교황_스테파노_2세	position	랑고바르드_왕국	x
교황_우르바노_8세	position	나폴리_왕국	x
궁예	position	개성특급시	x
김동엽	position	삼성그룹	x
김아랑	position	목	x
김영철_(희극인)	position	창원시	x
김유민	position	발해	x
김형호	position	포지션_(음악_그룹)	x
당_태종	position	고구려	x
당_헌종	position	당나라	x
도쿠가와_이에시게	position	에도_막부	x
동주_열왕	position	주나라	x
레오_6세_(비잔티움_제국)	position	콘스탄티노폴리스_총대주교_포티오스_1세	x
로널드_레이건	position	미국_주택도시개발부	x
로베르_2세_(프랑스)	position	부르고뉴	x
루이_14세	position	포르투갈	x
루이_16세	position	미국_재무부	x
마르코_(배우)	position	대한민국_내무부	x
모리야마_마유미	position	중의원	x
미꾸리속	position	한반도	x
박석민	position	머리	x
박정희	position	한국_광복군	x
박형	position	상주시	x
벨리사리우스	position	이탈리아	x
블라디미르_모노마흐	position	키예프	x
빌헬름_슈투카르트	position	대한민국_내무부	x
빌헬름_카이텔	position	무장친위대	x
살러시_페렌츠	position	국가사회주의_독일_노동자당	x
샤이반	position	중앙아시아	x
시빌라_(예루살렘_여왕)	position	유럽	x
아드리아누_레이치_히베이루	position	포지션_(음악_그룹)	x
안나_콤네네	position	공주시	x
에드워드_7세	position	작센코부르크고타_공국	x
오다_노부히데	position	무로마치_막부	x
오시마_다다모리	position	중의원	x
요한네스_4세	position	발칸_반도	x
위안스카이	position	붉은_군대	x
윌리엄_3세	position	아일랜드_왕국	x
윌리엄_적슨	position	캔터베리	x
유소_(유송)	position	위_(삼국)	x
유제프_안토니_포니아토프스키	position	오스트리아_연방육군	x
유진산	position	신민당_(1967년)	x
이건_(대한제국_황족)	position	서울시립대학교	x
이기붕	position	자유당_(대한민국)	x
이목희	position	상주시	x
이반_3세	position	러시아	x
이오시프_스탈린	position	유엔_평화유지군	x
자금우	position	한반도	x
전한_고제	position	후한	x
전한_무제	position	한나라	x
제_위왕	position	위_(삼국)	x
제임스_롱스트리트	position	제1군단_(대한민국)	x
조선_세조	position	강원도	x
조선_세조	position	고려	x
조지_W._부시	position	미국_국무부	x
존_맥도널드	position	보수당_(영국)	x
주_휴왕	position	주나라	x
짐_앤더튼	position	노동당_(영국)	x
참회왕_에드워드	position	아키텐	x
최문기	position	대한민국_미래창조과학부	x
카롤_1세	position	소련	x
카를_5세	position	우에스카	x
카를_5세	position	헝가리_왕국	x
카를_게프하르트	position	친위대_(나치)	x
카를로스_4세	position	스페인	x
콘라트_2세	position	베로나	x
틴다레오스	position	스파르타	x
펠리페_6세	position	공주시	x
표트르_2세	position	러시아_제국	x
프란츠_1세	position	로렌	x
프랑수아_1세_(프랑스)	position	랭스_대성당	x
프랑수아_1세_(프랑스)	position	이탈리아	x
프랑수아_1세_(프랑스)	position	플랑드르	x
프리드리히_2세_(프로이센)	position	오스트리아	x
프리드리히_아우구스트_1세	position	작센_왕국	x
피에르_루이지_베르사니	position	민주당_(미국)	x
하시모토_류타로	position	대일본청년당	x
한동우	position	신한금융그룹	x
함풍제	position	청나라	x
헌정회	position	중의원	x
헤라클레스	position	스파르타	x
현재윤	position	빗장뼈	x
후야오방	position	중화인민공화국_감찰부	x
후쿠시마_미즈호	position	참의원_(일본)	x
구글	product	웹킷	o
기아자동차	product	조선_단종	x
넥슨	product	한게임	o
넷플릭스	product	제시카_존스_(드라마)	o
닉툰스_(미국)	product	랜덤!_카툰스	x
루프트한자	product	루프트한자_시티라인	o
마블_코믹스	product	스타로드	x
마이크로소프트	product	마이크로소프트_워드	o
마이크로소프트	product	비주얼_C++	o
마이크로소프트	product	안드로이드_(운영_체제)	o
마이크로소프트	product	액티브X	o
마크로젠	product	바이오	x
모질라_재단	product	시몽키	o
모토로라_인코퍼레이티드	product	모토블러	o
삼성SDS	product	넥슨_코리아	x
소니_인터랙티브_엔터테인먼트	product	안드로이드_(운영_체제)	o
슈에이샤	product	바쿠만	o
어도비_시스템즈	product	아파치_플렉스	o
포드_모터_컴퍼니	product	푸조	x
한창여객	product	FIFA_월드컵	x
DJMAX_RAY	publisher	네오위즈홀딩스	o
나이트_온라인	publisher	엠게임	o
네버윈터_나이츠	publisher	바이오웨어	o
댄스_댄스_레볼루션_with_마리오	publisher	코나미	o
드래곤_컬렉션	publisher	코나미	o
리코쳇	publisher	밸브_코퍼레이션	o
마리오브라더스	publisher	닌텐도	o
메이플스토리	publisher	위젯_스튜디오	o
메이플스토리_2	publisher	넥슨	o
메탈레이지	publisher	넥슨지티	o
바이오쇼크_인피니트	publisher	마이크로소프트	o
박앵귀_~신선조기담~	publisher	오토메이트	x
뱀파이어_나이트	publisher	반다이_남코_엔터테인먼트	o
블레이드_앤_소울	publisher	엔씨소프트	o
스와트_4	publisher	비방디	o
심타워	publisher	마이크로소프트	o
완다와_거상	publisher	소니_인터랙티브_엔터테인먼트	o
워록	publisher	드림익스큐션	o
유비트_코피어스	publisher	코나미	o
포켓몬스터_오메가루비·알파사파이어	publisher	닌텐도	o
50센트	recordLabel	애프터매스_엔터테인먼트	o
닥터_드레	recordLabel	애프터매스_엔터테인먼트	o
데이먼_대시	recordLabel	데프_잼_레코딩스	o
데이먼_대시	recordLabel	로커펠라_레코드	o
디즈니_채널	recordLabel	할리우드_레코드	x
루다크리스	recordLabel	데프_잼_레코딩스	o
샤니아_트웨인	recordLabel	아리스타_레코드	o
숀_콤스	recordLabel	애프터매스_엔터테인먼트	o
애프터매스_엔터테인먼트	recordLabel	셰이디_레코드	o
어셔	recordLabel	아일랜드_레코드	o
에미넴	recordLabel	셰이디_레코드	o
자_룰	recordLabel	데프_잼_레코딩스	o
재팬_(밴드)	recordLabel	큔_뮤직	o
제이지	recordLabel	데프_잼_레코딩스	o
캄론	recordLabel	로커펠라_레코드	o
캠프_락	recordLabel	할리우드_레코드	o
탑_독_엔터테인먼트	recordLabel	인터스코프_레코드	o
필립스	recordLabel	도이체_그라모폰	x
한국	recordLabel	FNC_엔터테인먼트	x
한국	recordLabel	정글_엔터테인먼트	x
김규식	relative	안재홍	o
김동석_(1966년)	relative	장동건	o
김명봉	relative	김병현	x
김안국	relative	남곤	x
노엘_갤러거	relative	리엄_갤러거	o
루이즈_마운트배튼	relative	제1대_버마의_마운트배튼_백작_루이스_마운트배튼	o
박은식	relative	조동호	o
서재필	relative	박영효	o
셰인_맥마흔	relative	스테퍼니_맥마흔	o
안중근	relative	윤봉길	o
윤치영	relative	윤치호	o
이극로	relative	백남운	x
이기붕	relative	김규식	o
이상재	relative	허헌	o
이순신	relative	윤휴	o
장면	relative	장택상	o
정명훈	relative	정경화	o
주희	relative	주돈이	o
체사레_보르자	relative	호프레_보르자	o
테오_반_고흐_(미술상)	relative	빈센트_반_고흐	o
토마스_맥켈리	relative	프랜시스_휴스	o
한명회	relative	김질_(1422년)	o
호유용	relative	홍무제	x
홍명희	relative	허헌	o
교황_텔레스포로	religion	가르멜회	o
김석주	religion	소론	x
남인	religion	시파	x
도미니코	religion	도미니코_수도회	o
듀크_대학교	religion	예수회	x
로베르토_벨라르미노	religion	예수회	x
로욜라의_이냐시오	religion	예수회	x
민주당_(미국)	religion	민주파	x
바오로_미키	religion	예수회	x
브리검영_대학교	religion	예수_그리스도_후기성도_교회	o
서던캘리포니아_대학교	religion	기독교청년회	x
송시열	religion	소론	x
윌리엄_1세_(잉글랜드)	religion	프란치스코회	x
장제스	religion	신사군	x
정순왕후_(조선_영조)	religion	시파	x
조선_영조	religion	소론	x
줄리아노_데_메디치	religion	프란치스코회	x
카를루스_필리프_시메느스_벨루	religion	살레시오회	x
클레르보의_베르나르	religion	시토회	x
파도바의_안토니오	religion	프란치스코회	x
권기옥	spouse	김경오	x
기시_노부스케	spouse	아베_신조	o
김영춘_(1962년)	spouse	신기남	o
김진아_(배우)	spouse	양자경	o
김현중	spouse	구혜선	o
나가노_아이	spouse	서유리	x
나르세스	spouse	토틸라	o
나카무라_토오루	spouse	에모토_아키라	o
나카소네_야스히로	spouse	하시모토_류타로	o
니콜_키드먼	spouse	존_캐머런_미첼	o
데이비드_핀처	spouse	라세_할스트룀	o
돈_프레이저	spouse	페트리아_토머스	x
라이언_고즐링	spouse	캐리_멀리건	o
레이철_매캐덤스	spouse	베네딕트_웡	o
로멀러_개리	spouse	크리스토퍼_리	o
로베르트_슈벤트케	spouse	레이철_매캐덤스	o
뤄샤오쥐안	spouse	브리타_하이데만	x
리나_(펜싱_선수)	spouse	쉬안치	o
리나_(펜싱_선수)	spouse	타카하시_쥬리	x
리베카_슈거	spouse	펜들턴_워드	o
리즐_존스	spouse	페트리아_토머스	x
마이클_섀넌	spouse	코디_스밋맥피	o
막시_헤르버	spouse	에른스트_바이어	o
메리_2세_(잉글랜드)	spouse	조선_선조	x
모리쿠보_쇼타로	spouse	정명준	x
미셸_모너핸	spouse	모건_프리먼	o
박미선	spouse	김성은_(군인)	o
박상아	spouse	조민기	o
박수홍	spouse	윤기원_(배우)	o
박지아	spouse	하정우	o
백지영	spouse	박장근	o
버락_오바마	spouse	엘레나_케이건	o
부르빌	spouse	루이_드_퓌네스	o
브래드_피트	spouse	줄리아_로버츠	o
샤를리즈_테론	spouse	크리스티나_헨드릭스	o
서영교	spouse	김다니	o
선우용여	spouse	장정희	o
세라_페일린	spouse	존_매케인	o
송강호	spouse	존_허트	o
쉬안치	spouse	뤄샤오쥐안	o
스코티_톰프슨	spouse	브리트니_대니얼	o
스파이더맨	spouse	메리_제인_왓슨	o
시드니_폴락	spouse	바브라_스트라이샌드	o
신경숙	spouse	테레자_보우치코바	x
신창원	spouse	유영철	o
신현준_(군인)	spouse	정재영	o
아르투르_아빌라	spouse	만줄_바르가바	o
아리크부카	spouse	차가타이_칸	o
안석주	spouse	윤봉춘	o
알바로_오브레곤	spouse	에밀리아노_사파타	o
알베르토_후지모리	spouse	게이코_후지모리	o
애니_점프_캐넌	spouse	헨리에타_스완_리비트	o
애덤_무토	spouse	리베카_슈거	o
앤_해서웨이	spouse	로즈메리_디윗	o
앨프리드_히치콕	spouse	조지_큐커	o
엘리자베타_알렉세예브나	spouse	세르게이_키로프	o
오스트리아의_마리아_아말리아_(1701년)	spouse	페르디난도_1세_(양시칠리아)	o
오스트리아의_마리아_안토니아	spouse	로베르토_1세	x
요제프_1세	spouse	아말리아_호드리게스	x
요제프_2세	spouse	이사벨라_드_프랑스	x
우위썬	spouse	에런_엑하트	o
윌리엄_셰익스피어	spouse	엘런_테리	o
유재석	spouse	김준호_(희극인)	o
유진위	spouse	장만옥	o
의민태자	spouse	이은경	x
이대진	spouse	신동수_(야구인)	o
이루마	spouse	조지_윈스턴	o
이선주	spouse	한인숙	o
이선호_(성우)	spouse	타나카_마유미	x
이용규	spouse	홍현우	o
이효정_(배우)	spouse	선우재덕	o
임예진	spouse	남성진	o
임청하	spouse	관즈린	o
장석남	spouse	하성란	x
장성민	spouse	박중훈	o
장필순	spouse	박정운	o
잭_스나이더	spouse	매슈_구드	o
정우성	spouse	손예진	o
제러미_코빈	spouse	야니스_바루파키스	x
제시카_비엘	spouse	브래들리_쿠퍼	o
제시카_채스테인	spouse	톰_히들스턴	o
제이미_벨	spouse	틸다_스윈턴	o
조선_경종	spouse	헌애왕후	x
조선_태종	spouse	측천무후	o
조이_살다나	spouse	가모라	x
조지_클루니	spouse	브래드_피트	o
지미_카터	spouse	로널드_레이건	o
차지철	spouse	김계원	o
찰스_위드모어	spouse	케이트_오스틴	o
카를_5세	spouse	모리스_드_삭스	x
카야_스코델라리오	spouse	프랜시스_오코너	o
코엔_형제	spouse	하비에르_바르뎀	o
클린트_이스트우드	spouse	리_밴클리프	o
킬리언_머피	spouse	켈리_맥도널드	o
토머스_제퍼슨	spouse	에런_버	o
톰_행크스	spouse	아키바_골즈먼	o
펠리페_5세	spouse	파르마의_마리아_루이사_(1751년)	o
프랭클린_D._루스벨트	spouse	존_낸스_가너	o
프리드리히_하이에크	spouse	밀턴_프리드먼	o
헬무트_쇤	spouse	헤네스_바이스바일러	o
황신혜	spouse	김승수_(배우)	o
경마장_가는_길	subsequentWork	결혼_이야기	o
그들도_우리처럼	subsequentWork	결혼_이야기	o
나이트메어_(2010년_영화)	subsequentWork	파이널_데스티네이션_5	o
내_사랑_팥쥐	subsequentWork	위풍당당_그녀	o
다빈치_코드	subsequentWork	천사와_악마	o
더_딥_블루_씨	subsequentWork	미드나잇_인_파리	x
데쓰_프루프	subsequentWork	플래닛_테러	o
두사부일체	subsequentWork	색즉시공	o
로도스도_전기	subsequentWork	초시공요새_마크로스	x
미션_임파서블	subsequentWork	수퍼맨_리턴즈	o
바람_피기_좋은_날	subsequentWork	냄새를_보는_소녀_(드라마)	o
바이센테니얼맨	subsequentWork	판타스틱_4_(2005년_영화)	o
뻐꾸기_둥지_위로_날아간_새_(영화)	subsequentWork	양들의_침묵	x
세상의_중심에서_사랑을_외치다	subsequentWork	태양의_노래	o
슈퍼_마리오_랜드	subsequentWork	마더_(2009년_영화)	x
슈퍼스타_감사용	subsequentWork	돌아온_일지매	o
슈퍼스타_감사용	subsequentWork	비밀애	o
스타십_트루퍼스	subsequentWork	토탈_리콜	o
스트리트_킹	subsequentWork	퓨리_(2014년_영화)	o
에반_올마이티	subsequentWork	겟_스마트_(영화)	o
염신전대_고온저	subsequentWork	비너스_버서스_바이러스	x
요술공주_샐리	subsequentWork	바벨_2세	o
윈도우_비스타	subsequentWork	윈도우_서버_2008	x
잉글리쉬_페이션트	subsequentWork	콜드_마운틴	o
작안의_샤나	subsequentWork	토라도라!	o
쥬만지	subsequentWork	다이하드_3	o
지옥의_기계	subsequentWork	마녀와_야수	x
캔디맨_(영화)	subsequentWork	불멸의_연인	o
케이온!	subsequentWork	마법소녀_마도카☆마기카	x
콜롬비아나	subsequentWork	테이큰_3	o
판타스틱_4_(2015년_영화)	subsequentWork	엑스맨_(영화_시리즈)	o
2006년_FIFA_월드컵	team	발렌시아_CF	x
2012년_하계_올림픽_펜싱_여자_사브르_개인	team	대한민국_축구_국가대표팀	x
FIFA_월드컵	team	풀럼_FC	x
FIFA_클럽_월드컵	team	AC_밀란	o
K3리그	team	경주_시민축구단	o
K3리그	team	고려대학교_축구부	o
K리그	team	노스이스트_유나이티드_FC	o
K리그	team	전북_현대_모터스	o
UEFA_U-21_축구_선수권_대회	team	프랑스_축구_국가대표팀	x
UEFA_유럽_축구_선수권_대회	team	폴란드_축구_국가대표팀	x
UEFA_유로_2004_결승전	team	보스턴_셀틱스	x
그레미우	team	아틀레치쿠_파라나엔시	o
김민수_(격투기_선수)	team	서울_SK_나이츠	o
내셔널_하키_리그	team	토론토_메이플리프스	o
니코_(가수)	team	레알_마드리드_카스티야	o
대한민국_축구_국가대표팀	team	발렌시아_CF	o
대한민국_축구_국가대표팀	team	웨일스_축구_국가대표팀	x
데포르티보_라코루냐	team	리버풀_FC	o
덴버_너기츠	team	디트로이트_피스턴스	x
도널드_덕	team	뉴욕_양키스	o
라리가	team	SC_바스티아	o
라리가	team	레알_베티스	o
래리_존슨_(농구_선수)	team	뉴올리언스_펠리컨스	o
로사리오_센트랄	team	레알_마드리드_CF	x
리그_1	team	FC_낭트	o
리그_1	team	FC_서울	o
마이애미_말린스	team	신시내티_레즈	x
마이클_도슨_(로스트)	team	스토크_시티_FC	x
맷_홀리데이	team	뉴욕_양키스	o
배트맨	team	노리치_시티_FC	x
보카_주니어스	team	ACF_피오렌티나	x
비에이리냐	team	포르투갈_축구_국가대표팀	o
사우디아라비아_축구_국가대표팀	team	FC_서울	o
세골렌_루아얄	team	클뤼프_브뤼허_KV	x
세리에_A	team	포자_칼초	o
스웨덴_하키_리그	team	디트로이트_레드윙스	x
스코틀랜드_프리미어십	team	엑서터_치프스	x
스코틀랜드_프리미어십	team	할리퀸_FC	x
슬로베니아_여자_축구_국가대표팀	team	포르투갈_여자_축구_국가대표팀	x
시애틀_매리너스	team	텍사스_레인저스	x
시애틀_시호크스	team	피츠버그_스틸러스	x
아이티_축구_국가대표팀	team	대한민국_축구_국가대표팀	x
알나스르_(리야드)	team	사우디아라비아_축구_국가대표팀	x
알제리_축구_국가대표팀	team	독일_축구_국가대표팀	x
애스턴_빌라_FC	team	스완지_시티_AFC	x
에레디비시	team	브뢴뷔_IF	o
에밀리아노_사파타	team	VfB_슈투트가르트	x
에번즈빌_아이스멘	team	콜럼버스_카턴마우스	x
우니온	team	차카리타_주니어스	x
이라크_축구_국가대표팀	team	대한민국_축구_국가대표팀	x
인도_여자_축구_국가대표팀	team	포르투갈_여자_축구_국가대표팀	x
찰스_쉬렉	team	스토크_시티_FC	x
참회왕_에드워드	team	뉴욕_양키스	x
참회왕_에드워드	team	플로리다_팬서스	x
커트_실링	team	뉴욕_양키스	o
콘티넨탈_하키_리그	team	FC_디나모_모스크바	o
키프로스_축구_국가대표팀	team	대한민국_축구_국가대표팀	x
텍사스_레인저스	team	미네소타_트윈스	o
페르난도_에르난데스	team	디트로이트_타이거스	o
페예노르트	team	AC_밀란	o
포르투갈_축구_국가대표팀	team	SL_벤피카	o
프리미어리그	team	AFC_본머스	o
프리미어리그	team	탬파베이_버커니어스	x
피츠버그_파이리츠	team	애틀랜타_브레이브스	o
한국프로농구	team	보스턴_셀틱스	o
헤르타_BSC	team	우디네세_칼초	x
뉴욕_대학교	type	티시_예술대학	o
대한민국_국군	type	주한_미군	x
대한민국_국회	type	중의원	x
대한민국_재정경제부	type	전국은행연합회	x
데포르티보_파스토	type	파스토	x
도쿄_대학	type	와세다_대학	o
도쿄_도_교통국	type	도영	x
독일_사회민주당	type	민주당_(미국)	x
멜버른_대학교	type	와세다_대학	x
민주당_(미국)	type	중의원	x
브라운_대학교	type	예일_대학교	o
서일본여객철도	type	시영	x
스탠퍼드_대학교	type	와세다_대학	o
유엔_평화유지군	type	블루_(음악_그룹)	x
인천신흥초등학교	type	영화초등학교_(인천)	x
일본_국회	type	중의원	x
팬아메리칸_월드_항공	type	유나이티드_항공	x
하와이_대학교	type	미시간_주립_대학교	x
한국폴리텍6대학	type	한국폴리텍대학	o
한국폴리텍7대학	type	한국폴리텍대학	o
